Date,UNRATE,PAYEMS,USGOVT,USPRIV,USGOOD,SRVPRD,USCONS,MANEMP,USTPU,USFIRE,USPBS,U6RATE
2025-08-01,4.3,159540,23568,135972,21626,137914,8295,12722,29082,9250,22536,8.1
2025-07-01,4.2,159518,23584,135934,21651,137867,8302,12734,29080,9253,22553,7.9
2025-06-01,4.1,159439,23582,135857,21659,137780,8303,12736,29075,9244,22563,7.7
2025-05-01,4.2,159452,23568,135884,21680,137772,8305,12753,29088,9250,22587,7.8
2025-04-01,4.2,159433,23618,135815,21693,137740,8303,12764,29099,9243,22610,7.8
2025-03-01,4.2,159275,23593,135682,21691,137584,8303,12764,29101,9238,22583,7.9
2025-02-01,4.1,159155,23587,135568,21686,137469,8298,12763,29109,9235,22594,8.0
2025-01-01,4.0,159053,23592,135461,21662,137391,8286,12755,29087,9220,22579,7.5
2024-12-01,4.1,158942,23560,135382,21673,137269,8289,12760,29033,9206,22614,7.5
2024-11-01,4.2,158619,23524,135095,21669,136950,8274,12770,28952,9194,22578,7.7
2024-10-01,4.1,158358,23507,134851,21641,136717,8268,12750,28933,9178,22541,7.7
2024-09-01,4.1,158314,23462,134852,21691,136623,8267,12800,28943,9175,22575,7.7
2024-08-01,4.2,158074,23430,134644,21659,136415,8237,12800,28912,9170,22591,7.8
2024-07-01,4.2,158003,23392,134611,21677,136326,8214,12840,28919,9164,22623,7.8
2024-06-01,4.1,157915,23344,134571,21665,136250,8203,12839,28926,9167,22639,7.4
2024-05-01,4.0,157828,23323,134505,21661,136167,8188,12849,28935,9159,22656,7.4
2024-04-01,3.9,157635,23290,134345,21650,135985,8173,12847,28916,9152,22645,7.4
2024-03-01,3.9,157517,23301,134216,21645,135872,8170,12838,28891,9152,22637,7.3
2024-02-01,3.9,157271,23224,134047,21622,135649,8136,12853,28856,9155,22661,7.3
2024-01-01,3.7,157049,23153,133896,21611,135438,8113,12866,28819,9165,22667,7.2
2023-12-01,3.8,156930,23107,133823,21601,135329,8099,12865,28854,9176,22664,7.2
2023-11-01,3.7,156661,23051,133610,21579,135082,8085,12858,28775,9171,22659,7.0
2023-10-01,3.9,156520,23007,133513,21550,134970,8076,12836,28830,9174,22706,7.2
2023-09-01,3.8,156334,22938,133396,21558,134776,8049,12869,28801,9182,22724,7.0
2023-08-01,3.7,156176,22869,133307,21535,134641,8039,12856,28783,9190,22756,7.1
2023-07-01,3.5,156019,22820,133199,21519,134500,8014,12863,28811,9192,22772,6.7
2023-06-01,3.6,155871,22782,133089,21524,134347,8006,12877,28811,9183,22820,6.9
2023-05-01,3.6,155614,22695,132919,21481,134133,7965,12874,28834,9179,22846,6.7
2023-04-01,3.4,155387,22634,132753,21482,133905,7955,12889,28809,9182,22845,6.6
2023-03-01,3.5,155171,22585,132586,21456,133715,7931,12890,28831,9152,22834,6.7
2023-02-01,3.6,155086,22548,132538,21481,133605,7947,12900,28851,9156,22838,6.8
2023-01-01,3.5,154780,22492,132288,21453,133327,7922,12897,28811,9144,22798,6.7
2022-12-01,3.5,154336,22373,131963,21407,132929,7892,12889,28747,9141,22791,6.6
2022-11-01,3.6,154210,22374,131836,21384,132826,7864,12896,28727,9132,22797,6.7
2022-10-01,3.6,153913,22309,131604,21346,132567,7846,12883,28731,9119,22784,6.7
2022-09-01,3.5,153513,22280,131233,21289,132224,7827,12848,28700,9093,22733,6.7
2022-08-01,3.6,153286,22269,131017,21237,132049,7799,12826,28738,9088,22689,6.9
2022-07-01,3.5,153049,22282,130767,21203,131846,7789,12800,28706,9072,22652,6.8
2022-06-01,3.6,152353,22124,130229,21137,131216,7760,12768,28669,9059,22559,6.7
2022-05-01,3.6,151892,22103,129789,21076,130816,7737,12739,28586,9051,22496,7.1
2022-04-01,3.7,151651,22079,129572,21022,130629,7699,12725,28607,9043,22479,7.0
2022-03-01,3.7,151346,22042,129304,20961,130385,7695,12676,28615,9004,22480,7.0
2022-02-01,3.8,150875,22041,128834,20856,130019,7667,12608,28556,8985,22363,7.2
2022-01-01,4.0,150006,22056,127950,20723,129283,7586,12560,28310,8935,22198,7.1
2021-12-01,3.9,149781,22074,127707,20709,129072,7601,12532,28220,8934,22139,7.3
2021-11-01,4.2,149206,22044,127162,20635,128571,7565,12498,28117,8908,22026,7.7
2021-10-01,4.5,148569,22043,126526,20543,128026,7520,12454,27967,8877,21879,8.2
2021-09-01,4.7,147712,22080,125632,20434,127278,7478,12391,27825,8847,21630,8.4
2021-08-01,5.1,147246,22099,125147,20345,126901,7431,12349,27698,8821,21530,8.8
2021-07-01,5.4,146759,22055,124704,20282,126477,7417,12303,27643,8803,21419,9.2
2021-06-01,5.9,145828,22004,123824,20201,125627,7392,12249,27592,8769,21258,9.8
2021-05-01,5.8,145032,21910,123122,20164,124868,7389,12219,27444,8762,21168,10.1
2021-04-01,6.1,144611,21909,122702,20147,124464,7401,12191,27396,8755,21110,10.3
2021-03-01,6.1,144246,21856,122390,20185,124061,7399,12232,27436,8738,21100,10.8
2021-02-01,6.2,143422,21764,121658,20011,123411,7293,12179,27301,8727,20988,11.1
2021-01-01,6.4,142913,21779,121134,20046,122867,7358,12145,27220,8729,20912,11.2
2020-12-01,6.7,142548,21678,120870,20067,122481,7357,12153,27158,8718,20770,11.7
2020-11-01,6.7,142731,21683,121048,19993,122738,7321,12118,27112,8704,20602,11.9
2020-10-01,6.9,142461,21805,120656,19943,122518,7301,12086,26947,8692,20455,12.1
2020-09-01,7.8,141770,21929,119841,19871,121899,7253,12057,26746,8674,20267,12.8
2020-08-01,8.4,140819,22000,118819,19786,121033,7226,11999,26613,8647,20147,14.2
2020-07-01,10.2,139255,21514,117741,19738,119517,7196,11973,26231,8623,19953,16.5
2020-06-01,11.0,137671,21412,116259,19688,117983,7159,11950,25963,8622,19768,18.0
2020-05-01,13.2,133040,21393,111647,19209,113831,7004,11610,24975,8607,19410,21.1
2020-04-01,14.8,130424,21909,108515,18523,111901,6522,11382,24564,8590,19223,22.9
2020-03-01,4.4,150895,22827,128068,20903,129992,7541,12684,27659,8855,21388,8.8
2020-02-01,3.5,152292,22857,129435,21037,131255,7610,12743,27738,8871,21483,7.0
2020-01-01,3.6,152031,22781,129250,20999,131032,7575,12745,27775,8833,21476,7.0
2019-12-01,3.6,151795,22726,129069,20980,130815,7527,12760,27758,8823,21467,6.8
2019-11-01,3.6,151668,22709,128959,21023,130645,7541,12777,27687,8814,21487,6.8
2019-10-01,3.6,151460,22670,128790,21003,130457,7553,12733,27688,8801,21476,6.9
2019-09-01,3.5,151365,22653,128712,21051,130314,7547,12787,27676,8785,21465,6.9
2019-08-01,3.6,151171,22625,128546,21038,130133,7530,12789,27652,8787,21455,7.2
2019-07-01,3.7,150936,22572,128364,21044,129892,7526,12790,27661,8770,21421,6.9
2019-06-01,3.6,150839,22604,128235,21023,129816,7502,12787,27645,8749,21402,7.2
2019-05-01,3.6,150621,22562,128059,20994,129627,7478,12778,27632,8736,21356,7.1
2019-04-01,3.7,150593,22619,127974,20992,129601,7468,12785,27626,8723,21315,7.4
2019-03-01,3.8,150295,22569,127726,20955,129340,7425,12788,27592,8705,21258,7.4
2019-02-01,3.8,150065,22525,127540,20920,129145,7395,12782,27591,8683,21230,7.2
2019-01-01,4.0,150059,22508,127551,20960,129099,7425,12790,27633,8671,21201,8.0
2018-12-01,3.9,149809,22511,127298,20900,128909,7396,12761,27580,8661,21196,7.6
2018-11-01,3.8,149617,22473,127144,20861,128756,7386,12741,27638,8651,21176,7.6
2018-10-01,3.8,149526,22479,127047,20861,128665,7389,12731,27569,8643,21171,7.5
2018-09-01,3.7,149358,22474,126884,20823,128535,7375,12710,27577,8629,21145,7.5
2018-08-01,3.8,149279,22468,126811,20772,128507,7347,12688,27602,8612,21112,7.4
2018-07-01,3.8,149020,22436,126584,20724,128296,7318,12676,27545,8600,21073,7.5
2018-06-01,4.0,148959,22482,126477,20678,128281,7292,12656,27542,8590,21060,7.8
2018-05-01,3.8,148740,22449,126291,20623,128117,7274,12623,27565,8572,21011,7.8
2018-04-01,4.0,148422,22444,125978,20529,127893,7212,12595,27517,8546,20952,7.9
2018-03-01,4.0,148280,22427,125853,20484,127796,7194,12576,27519,8538,20908,8.0
2018-02-01,4.1,148054,22419,125635,20442,127612,7184,12551,27447,8527,20861,8.1
2018-01-01,4.0,147660,22374,125286,20318,127342,7093,12527,27370,8503,20822,8.0
2017-12-01,4.1,147523,22384,125139,20286,127237,7091,12501,27404,8496,20764,8.1
2017-11-01,4.2,147373,22379,124994,20231,127142,7068,12472,27416,8490,20725,8.0
2017-10-01,4.2,147150,22361,124789,20174,126976,7031,12457,27374,8482,20709,8.1
2017-09-01,4.3,147007,22333,124674,20141,126866,7013,12443,27355,8479,20668,8.3
2017-08-01,4.4,146919,22310,124609,20120,126799,7002,12435,27333,8476,20671,8.6
2017-07-01,4.3,146772,22374,124398,20038,126734,6968,12390,27325,8465,20632,8.5
2017-06-01,4.3,146583,22360,124223,20029,126554,6962,12390,27321,8452,20589,8.5
2017-05-01,4.4,146380,22347,124033,19982,126398,6931,12377,27307,8436,20556,8.5
2017-04-01,4.4,146174,22335,123839,19952,126222,6916,12367,27301,8424,20494,8.6
2017-03-01,4.4,145969,22329,123640,19923,126046,6902,12361,27298,8407,20463,8.8
2017-02-01,4.6,145848,22326,123522,19887,125961,6881,12350,27311,8400,20433,9.0
2017-01-01,4.7,145628,22316,123312,19821,125807,6840,12334,27314,8397,20415,9.2
2016-12-01,4.7,145408,22304,123104,19789,125619,6818,12324,27270,8370,20374,9.2
2016-11-01,4.7,145183,22277,122906,19781,125402,6823,12311,27209,8344,20340,9.4
2016-10-01,4.9,145066,22295,122771,19759,125307,6799,12316,27235,8333,20303,9.6
2016-09-01,5.0,144967,22323,122644,19730,125237,6768,12317,27211,8327,20281,9.7
2016-08-01,4.9,144662,22284,122378,19702,124960,6736,12319,27199,8320,20212,9.6
2016-07-01,4.8,144520,22289,122231,19729,124791,6735,12342,27153,8304,20208,9.6
2016-06-01,4.9,144146,22180,121966,19679,124467,6701,12321,27107,8281,20162,9.5
2016-05-01,4.8,143900,22199,121701,19659,124241,6689,12303,27089,8265,20120,9.9
2016-04-01,5.1,143855,22184,121671,19705,124150,6702,12325,27072,8249,20113,9.9
2016-03-01,5.0,143662,22178,121484,19682,123980,6678,12313,27054,8226,20082,9.8
2016-02-01,4.9,143407,22138,121269,19687,123720,6640,12337,26978,8210,20058,9.6
2016-01-01,4.8,143210,22114,121096,19717,123493,6631,12354,26915,8207,20046,9.7
2015-12-01,5.0,143077,22097,120980,19709,123368,6630,12333,26909,8189,20035,9.9
2015-11-01,5.1,142808,22081,120727,19682,123126,6598,12329,26875,8182,19965,10.0
2015-10-01,5.0,142579,22056,120523,19651,122928,6547,12334,26851,8167,19930,9.8
2015-09-01,5.0,142275,22040,120235,19614,122661,6508,12326,26810,8152,19855,10.0
2015-08-01,5.1,142125,22060,120065,19602,122523,6490,12318,26822,8145,19835,10.2
2015-07-01,5.2,141991,22050,119941,19602,122389,6472,12323,26802,8134,19803,10.3
2015-06-01,5.3,141709,22015,119694,19565,122144,6441,12307,26764,8115,19768,10.4
2015-05-01,5.6,141538,22012,119526,19556,121982,6427,12306,26727,8097,19718,10.9
2015-04-01,5.4,141196,22005,119191,19527,121669,6392,12291,26662,8086,19635,10.9
2015-03-01,5.4,140923,21970,118953,19480,121443,6334,12286,26646,8081,19592,10.9
2015-02-01,5.5,140827,21978,118849,19511,121316,6361,12275,26599,8070,19563,10.9
2015-01-01,5.7,140568,21960,118608,19473,121095,6320,12265,26557,8059,19519,11.2
2014-12-01,5.6,140364,21947,118417,19454,120910,6293,12266,26527,8042,19494,11.2
2014-11-01,5.8,140090,21932,118158,19431,120659,6272,12260,26475,8036,19415,11.4
2014-10-01,5.7,139797,21917,117880,19391,120406,6259,12233,26424,8018,19359,11.5
2014-09-01,5.9,139563,21897,117666,19347,120216,6242,12201,26363,8009,19330,11.7
2014-08-01,6.1,139269,21855,117414,19291,119978,6210,12182,26316,7994,19274,12.0
2014-07-01,6.2,139073,21901,117172,19240,119833,6178,12165,26292,7980,19216,12.1
2014-06-01,6.1,138849,21895,116954,19172,119677,6133,12146,26238,7965,19178,12.0
2014-05-01,6.3,138512,21832,116680,19117,119395,6109,12120,26165,7951,19117,12.3
2014-04-01,6.2,138297,21853,116444,19079,119218,6084,12109,26122,7944,19076,12.3
2014-03-01,6.7,137985,21833,116152,19013,118972,6038,12096,26055,7932,19018,12.7
2014-02-01,6.7,137712,21825,115887,18966,118746,6007,12084,26004,7932,18971,12.6
2014-01-01,6.6,137561,21814,115747,18914,118647,5985,12058,26029,7913,18909,12.6
2013-12-01,6.7,137373,21820,115553,18858,118515,5932,12060,26012,7916,18862,13.1
2013-11-01,6.9,137316,21843,115473,18885,118431,5963,12054,25939,7911,18873,13.1
2013-10-01,7.2,137041,21830,115211,18832,118209,5931,12033,25882,7912,18805,13.6
2013-09-01,7.2,136821,21835,114986,18788,118033,5910,12010,25858,7903,18755,13.5
2013-08-01,7.2,136646,21831,114815,18737,117909,5878,11992,25793,7902,18725,13.6
2013-07-01,7.3,136391,21815,114576,18684,117707,5859,11962,25725,7904,18698,13.8
2013-06-01,7.5,136279,21840,114439,18701,117578,5855,11982,25682,7887,18651,14.2
2013-05-01,7.5,136095,21864,114231,18668,117427,5829,11978,25625,7883,18605,13.9
2013-04-01,7.6,135873,21869,114004,18631,117242,5796,11978,25590,7872,18551,14.0
2013-03-01,7.5,135689,21870,113819,18639,117050,5802,11977,25564,7856,18489,13.9
2013-02-01,7.7,135545,21881,113664,18616,116929,5784,11974,25569,7851,18433,14.3
2013-01-01,8.0,135257,21869,113388,18561,116696,5746,11962,25545,7837,18340,14.5
2012-12-01,7.9,135074,21887,113187,18512,116562,5724,11939,25508,7829,18298,14.4
2012-11-01,7.7,134825,21883,112942,18458,116367,5684,11930,25495,7816,18261,14.4
2012-10-01,7.8,134668,21903,112765,18452,116216,5674,11941,25427,7809,18207,14.4
2012-09-01,7.8,134517,21925,112592,18442,116075,5661,11934,25387,7800,18134,14.8
2012-08-01,8.1,134338,21916,112422,18440,115898,5648,11940,25361,7787,18118,14.6
2012-07-01,8.2,134157,21913,112244,18427,115730,5632,11944,25329,7778,18084,14.7
2012-06-01,8.2,134012,21930,112082,18391,115621,5621,11918,25323,7781,18042,14.7
2012-05-01,8.2,133933,21911,112022,18367,115566,5604,11908,25337,7782,17986,14.8
2012-04-01,8.2,133825,21931,111894,18365,115460,5618,11897,25285,7771,17961,14.7
2012-03-01,8.2,133748,21943,111805,18354,115394,5625,11880,25276,7767,17912,14.6
2012-02-01,8.3,133508,21947,111561,18316,115192,5629,11841,25246,7744,17878,15.0
2012-01-01,8.3,133245,21946,111299,18287,114958,5626,11820,25217,7735,17808,15.1
2011-12-01,8.5,132888,21954,110934,18225,114663,5611,11783,25124,7729,17722,15.2
2011-11-01,8.6,132690,21971,110719,18171,114519,5593,11753,25111,7721,17654,15.6
2011-10-01,8.8,132553,21998,110555,18170,114383,5588,11762,25083,7708,17618,15.8
2011-09-01,9.0,132344,21983,110361,18148,114196,5584,11752,25046,7695,17571,16.4
2011-08-01,9.0,132125,22017,110108,18105,114020,5552,11748,25029,7697,17506,16.1
2011-07-01,9.0,131993,22049,109944,18075,113918,5547,11729,25010,7693,17431,15.9
2011-06-01,9.1,131931,22164,109767,18026,113905,5528,11710,24962,7690,17424,16.1
2011-05-01,9.0,131704,22129,109575,17990,113714,5516,11697,24906,7702,17407,15.9
2011-04-01,9.1,131597,22184,109413,17941,113656,5485,11689,24891,7680,17356,16.1
2011-03-01,9.0,131282,22192,109090,17890,113392,5477,11659,24794,7681,17294,16.0
2011-02-01,9.0,131056,22215,108841,17826,113230,5451,11637,24746,7676,17229,16.0
2011-01-01,9.1,130837,22258,108579,17770,113067,5427,11606,24675,7680,17150,16.1
2010-12-01,9.3,130830,22266,108564,17780,113050,5467,11579,24657,7684,17140,16.6
2010-11-01,9.8,130749,22287,108462,17813,112936,5506,11571,24625,7680,17069,16.9
2010-10-01,9.4,130621,22297,108324,17788,112833,5508,11548,24626,7683,16975,16.6
2010-09-01,9.5,130342,22247,108095,17772,112570,5501,11549,24564,7682,16906,16.9
2010-08-01,9.5,130416,22420,107996,17778,112638,5524,11538,24537,7675,16888,16.5
2010-07-01,9.4,130415,22569,107846,17763,112652,5508,11546,24526,7676,16828,16.4
2010-06-01,9.4,130509,22740,107769,17747,112762,5516,11529,24505,7687,16818,16.4
2010-05-01,9.6,130643,22996,107647,17727,112916,5520,11511,24483,7699,16756,16.7
2010-04-01,9.9,130120,22569,107551,17715,112405,5553,11475,24469,7711,16721,17.2
2010-03-01,9.9,129865,22518,107347,17657,112208,5537,11439,24467,7708,16629,17.1
2010-02-01,9.8,129705,22476,107229,17613,112092,5500,11439,24421,7725,16646,17.0
2010-01-01,9.8,129802,22491,107311,17693,112109,5580,11447,24433,7733,16627,16.6
2009-12-01,9.9,129808,22482,107326,17782,112026,5654,11465,24384,7744,16605,17.2
2009-11-01,9.9,130058,22533,107525,17858,112200,5696,11498,24480,7756,16601,17.1
2009-10-01,10.0,130062,22524,107538,17904,112158,5716,11527,24516,7751,16543,17.1
2009-09-01,9.8,130247,22451,107796,18034,112213,5787,11580,24599,7770,16522,16.7
2009-08-01,9.6,130472,22537,107935,18136,112336,5855,11612,24656,7780,16515,16.7
2009-07-01,9.5,130662,22521,108141,18264,112398,5932,11654,24692,7805,16524,16.4
2009-06-01,9.5,131007,22576,108431,18409,112598,6010,11713,24795,7819,16547,16.5
2009-05-01,9.4,131468,22617,108851,18644,112824,6100,11850,24849,7844,16652,16.5
2009-04-01,9.0,131821,22677,109144,18881,112940,6154,12017,24909,7872,16703,15.9
2009-03-01,8.7,132492,22560,109932,19214,113278,6291,12196,25066,7927,16837,15.8
2009-02-01,8.3,133317,22576,110741,19565,113752,6446,12371,25229,7969,16988,15.1
2009-01-01,7.8,134078,22579,111499,19879,114199,6567,12552,25383,8017,17183,14.1
2008-12-01,7.3,134847,22556,112291,20313,114534,6701,12842,25523,8067,17337,13.6
2008-11-01,6.8,135543,22560,112983,20615,114928,6813,13026,25696,8100,17468,12.7
2008-10-01,6.5,136293,22549,113744,20886,115407,6967,13138,25902,8139,17640,11.8
2008-09-01,6.1,136762,22537,114225,21095,115667,7044,13267,26013,8173,17748,11.1
2008-08-01,6.1,137211,22567,114644,21242,115969,7114,13348,26126,8205,17817,10.8
2008-07-01,5.8,137498,22568,114930,21349,116149,7160,13419,26226,8219,17881,10.5
2008-06-01,5.6,137698,22517,115181,21475,116223,7213,13494,26290,8236,17940,10.0
2008-05-01,5.4,137851,22483,115368,21593,116258,7274,13555,26338,8249,17984,9.7
2008-04-01,5.0,138038,22450,115588,21671,116367,7327,13589,26425,8258,18041,9.2
2008-03-01,5.1,138257,22443,115814,21810,116447,7406,13650,26525,8268,18051,9.1
2008-02-01,4.9,138327,22417,115910,21890,116437,7453,13690,26545,8269,18093,9.0
2008-01-01,5.0,138391,22388,116003,21939,116452,7476,13717,26586,8276,18138,9.1
2007-12-01,5.0,138395,22376,116019,21968,116427,7490,13739,26608,8280,18148,8.8
2007-11-01,4.7,138291,22334,115957,22008,116283,7523,13751,26614,8291,18102,8.5
2007-10-01,4.7,138177,22297,115880,22050,116127,7565,13756,26553,8306,18101,8.4
2007-09-01,4.7,138101,22279,115822,22089,116012,7577,13784,26557,8319,18066,8.4
2007-08-01,4.6,138013,22226,115787,22159,115854,7610,13821,26525,8342,18067,8.4
2007-07-01,4.7,138044,22171,115873,22269,115775,7660,13881,26528,8370,18057,8.4
2007-06-01,4.6,138069,22207,115862,22315,115754,7687,13903,26514,8368,18053,8.3
2007-05-01,4.4,137993,22193,115800,22316,115677,7673,13922,26520,8371,18042,8.2
2007-04-01,4.5,137845,22175,115670,22345,115500,7686,13939,26491,8362,18008,8.2
2007-03-01,4.4,137782,22149,115633,22384,115398,7706,13964,26492,8381,17990,8.0
2007-02-01,4.5,137558,22131,115427,22329,115229,7626,13993,26426,8391,17960,8.1
2007-01-01,4.6,137472,22095,115377,22434,115038,7725,14004,26381,8388,17927,8.3
2006-12-01,4.4,137249,22088,115161,22398,114851,7685,14009,26340,8391,17863,7.9
2006-11-01,4.5,137061,22083,114978,22400,114661,7666,14034,26293,8392,17828,8.1
2006-10-01,4.4,136846,22068,114778,22449,114397,7682,14068,26233,8384,17760,8.2
2006-09-01,4.5,136829,22082,114747,22533,114296,7718,14120,26193,8389,17756,8.0
2006-08-01,4.7,136693,22011,114682,22566,114127,7720,14154,26172,8373,17766,8.4
2006-07-01,4.7,136529,21973,114556,22587,113942,7712,14185,26161,8366,17720,8.5
2006-06-01,4.6,136335,21922,114413,22594,113741,7699,14210,26136,8364,17680,8.4
2006-05-01,4.6,136249,21926,114323,22594,113655,7713,14200,26116,8376,17611,8.2
2006-04-01,4.7,136208,21919,114289,22627,113581,7726,14223,26123,8372,17552,8.1
2006-03-01,4.7,136036,21903,114133,22567,113469,7689,14210,26129,8350,17530,8.2
2006-02-01,4.8,135731,21878,113853,22533,113198,7664,14208,26090,8333,17444,8.4
2006-01-01,4.7,135426,21847,113579,22465,112961,7601,14208,26057,8305,17383,8.4
2005-12-01,4.9,135158,21879,113279,22373,112785,7533,14189,26033,8284,17330,8.6
2005-11-01,5.0,134999,21859,113140,22355,112644,7524,14184,26013,8281,17297,8.7
2005-10-01,5.0,134643,21829,112814,22290,112353,7460,14189,25957,8259,17216,8.7
2005-09-01,5.0,134554,21845,112709,22223,112331,7415,14173,25945,8224,17195,9.0
2005-08-01,4.9,134503,21863,112640,22224,112279,7394,14200,25965,8215,17124,8.9
2005-07-01,5.0,134300,21857,112443,22204,112096,7353,14225,25933,8191,17065,8.8
2005-06-01,5.0,133947,21763,112184,22184,111763,7333,14227,25869,8172,16999,9.0
2005-05-01,5.1,133689,21781,111908,22170,111519,7294,14255,25824,8154,16910,8.9
2005-04-01,5.2,133519,21754,111765,22135,111384,7266,14249,25786,8150,16888,9.0
2005-03-01,5.2,133152,21740,111412,22065,111087,7181,14268,25710,8139,16826,9.1
2005-02-01,5.4,133033,21744,111289,22035,110998,7153,14272,25691,8146,16798,9.2
2005-01-01,5.3,132781,21735,111046,21959,110822,7095,14257,25625,8143,16714,9.2
2004-12-01,5.4,132629,21693,110936,22004,110625,7117,14285,25598,8133,16659,9.3
2004-11-01,5.4,132504,21692,110812,21996,110508,7091,14306,25575,8117,16643,9.4
2004-10-01,5.5,132431,21656,110775,22004,110427,7077,14332,25556,8115,16661,9.7
2004-09-01,5.4,132091,21635,110456,21958,110133,7029,14332,25518,8120,16542,9.4
2004-08-01,5.4,131940,21626,110314,21943,109997,7003,14345,25468,8107,16519,9.4
2004-07-01,5.5,131853,21606,110247,21902,109951,6977,14331,25456,8099,16520,9.5
2004-06-01,5.6,131794,21601,110193,21887,109907,6962,14334,25456,8116,16481,9.6
2004-05-01,5.6,131697,21614,110083,21881,109816,6948,14342,25415,8115,16449,9.7
2004-04-01,5.6,131412,21614,109798,21802,109610,6901,14315,25386,8097,16376,9.6
2004-03-01,5.8,131139,21588,109551,21758,109381,6887,14287,25352,8085,16264,10.0
2004-02-01,5.6,130820,21550,109270,21693,109127,6838,14279,25280,8078,16238,9.7
2004-01-01,5.7,130756,21538,109218,21714,109042,6848,14291,25272,8078,16223,9.8
2003-12-01,5.7,130589,21546,109043,21701,108888,6827,14299,25183,8076,16195,9.8
2003-11-01,5.8,130481,21535,108946,21688,108793,6796,14316,25192,8083,16169,10.1
2003-10-01,6.0,130440,21558,108882,21692,108748,6784,14334,25209,8090,16130,10.2
2003-09-01,6.1,130253,21504,108749,21699,108554,6783,14346,25185,8100,16107,10.4
2003-08-01,6.1,130153,21556,108597,21706,108447,6760,14376,25147,8102,16052,10.1
2003-07-01,6.2,130184,21633,108551,21709,108475,6735,14403,25126,8101,16057,10.3
2003-06-01,6.3,130185,21606,108579,21788,108397,6723,14493,25154,8089,16018,10.3
2003-05-01,6.1,130196,21567,108629,21834,108362,6706,14558,25192,8093,16004,10.1
2003-04-01,6.0,130172,21595,108577,21863,108309,6689,14608,25213,8076,15954,10.2
2003-03-01,5.9,130235,21610,108625,21945,108290,6654,14721,25228,8051,15951,10.0
2003-02-01,5.9,130441,21624,108817,22022,108419,6667,14780,25272,8037,16021,10.1
2003-01-01,5.8,130573,21626,108947,22146,108427,6704,14867,25296,8025,15993,9.9
2002-12-01,6.0,130465,21588,108877,22188,108277,6700,14911,25342,8017,15927,9.8
2002-11-01,5.9,130616,21581,109035,22282,108334,6713,14992,25330,8003,15991,9.8
2002-10-01,5.7,130617,21559,109058,22323,108294,6689,15059,25362,7991,16033,9.6
2002-09-01,5.7,130503,21546,108957,22396,108107,6702,15119,25349,7965,16016,9.6
2002-08-01,5.7,130582,21589,108993,22448,108134,6701,15171,25397,7950,16038,9.6
2002-07-01,5.8,130583,21544,109039,22521,108062,6688,15256,25450,7942,16009,9.6
2002-06-01,5.8,130673,21549,109124,22577,108096,6701,15297,25442,7938,16082,9.5
2002-05-01,5.8,130632,21514,109118,22606,108026,6684,15338,25441,7933,16092,9.6
2002-04-01,5.9,130615,21443,109172,22689,107926,6710,15392,25457,7935,16082,9.7
2002-03-01,5.7,130722,21431,109291,22787,107935,6755,15443,25470,7929,16082,9.4
2002-02-01,5.7,130736,21390,109346,22880,107856,6766,15518,25480,7931,16066,9.5
2002-01-01,5.7,130859,21377,109482,22963,107896,6775,15588,25486,7939,16096,9.4
2001-12-01,5.7,130983,21355,109628,23094,107889,6785,15712,25548,7934,16132,9.6
2001-11-01,5.5,131144,21326,109818,23209,107935,6784,15825,25632,7940,16158,9.4
2001-10-01,5.3,131452,21275,110177,23379,108073,6804,15973,25718,7925,16285,9.3
2001-09-01,5.0,131763,21242,110521,23535,108228,6813,16116,25790,7916,16387,8.7
2001-08-01,4.9,132021,21218,110803,23668,108353,6827,16233,25875,7916,16473,8.2
2001-07-01,4.6,132171,21185,110986,23836,108335,6845,16381,25886,7891,16535,7.9
2001-06-01,4.5,132299,21137,111162,23963,108336,6840,16513,25958,7904,16588,7.9
2001-05-01,4.3,132409,21029,111380,24118,108291,6849,16660,25992,7899,16654,7.5
2001-04-01,4.4,132457,20992,111465,24255,108202,6844,16802,26007,7888,16698,7.4
2001-03-01,4.3,132751,20945,111806,24410,108341,6862,16938,26139,7885,16824,7.3
2001-02-01,4.2,132788,20906,111882,24478,108310,6841,17030,26177,7868,16874,7.3
2001-01-01,4.2,132703,20835,111868,24535,108168,6824,17105,26180,7845,16898,7.3
2000-12-01,3.9,132716,20804,111912,24574,108142,6792,17181,26263,7838,16893,6.9
2000-11-01,3.9,132556,20760,111796,24624,107932,6817,17202,26210,7823,16909,7.1
2000-10-01,3.9,132352,20743,111609,24638,107714,6814,17217,26193,7809,16868,6.8
2000-09-01,3.9,132338,20735,111603,24641,107697,6807,17229,26175,7798,16855,7.0
2000-08-01,4.1,132234,20837,111397,24683,107551,6796,17287,26179,7777,16793,7.1
2000-07-01,4.0,132228,20867,111361,24717,107511,6794,17322,26150,7766,16761,7.0
2000-06-01,4.0,132062,20887,111175,24670,107392,6778,17295,26140,7763,16716,7.0
2000-05-01,4.0,132105,21147,110958,24646,107459,6770,17278,26118,7762,16647,7.1
2000-04-01,3.8,131883,20802,111081,24689,107194,6794,17299,26184,7763,16682,6.9
2000-03-01,4.0,131604,20733,110871,24706,106898,6811,17302,26118,7767,16599,7.1
2000-02-01,4.1,131121,20599,110522,24608,106513,6730,17284,26061,7772,16525,7.1
2000-01-01,4.0,131011,20571,110440,24629,106382,6752,17284,26043,7769,16488,7.0
1999-12-01,4.0,130783,20540,110243,24581,106202,6709,17279,26019,7775,16412,7.1
1999-11-01,4.1,130467,20496,109971,24561,105906,6687,17282,25920,7773,16339,7.2
1999-10-01,4.1,130178,20457,109721,24506,105672,6640,17274,25882,7770,16279,7.2
1999-09-01,4.2,129772,20404,109368,24486,105286,6613,17282,25829,7771,16125,7.4
1999-08-01,4.2,129572,20375,109197,24467,105105,6586,17287,25774,7778,16101,7.3
1999-07-01,4.3,129421,20339,109082,24473,104948,6571,17308,25745,7780,16062,7.5
1999-06-01,4.3,129084,20272,108812,24433,104651,6547,17294,25680,7762,15983,7.5
1999-05-01,4.2,128813,20229,108584,24445,104368,6516,17333,25630,7746,15895,7.4
1999-04-01,4.3,128596,20237,108359,24425,104171,6480,17343,25580,7735,15828,7.7
1999-03-01,4.2,128234,20168,108066,24378,103856,6402,17368,25520,7722,15751,7.5
1999-02-01,4.4,128118,20144,107974,24434,103684,6429,17395,25484,7714,15704,7.7
1999-01-01,4.3,127699,20084,107615,24401,103298,6357,17427,25380,7706,15626,7.6
1998-12-01,4.4,127595,20079,107516,24454,103141,6378,17449,25361,7682,15567,7.6
1998-11-01,4.4,127223,20044,107179,24395,102828,6301,17466,25291,7664,15476,7.7
1998-10-01,4.5,126948,20001,106947,24406,102542,6262,17512,25240,7647,15393,7.9
1998-09-01,4.6,126744,19985,106759,24419,102325,6225,17557,25224,7624,15292,8.0
1998-08-01,4.5,126546,19959,106587,24420,102126,6215,17563,25183,7605,15287,7.9
1998-07-01,4.5,126211,19930,106281,24238,101973,6172,17423,25144,7594,15229,8.2
1998-06-01,4.5,126076,19879,106197,24385,101691,6130,17607,25104,7561,15196,8.1
1998-05-01,4.4,125846,19875,105971,24362,101484,6087,17624,25073,7535,15114,8.0
1998-04-01,4.3,125446,19816,105630,24340,101106,6049,17637,24995,7508,15022,8.0
1998-03-01,4.7,125165,19792,105373,24263,100902,5969,17637,24962,7485,14975,8.4
1998-02-01,4.6,125017,19786,105231,24282,100735,5997,17627,24945,7450,14923,8.3
1998-01-01,4.6,124806,19770,105036,24261,100545,5983,17619,24927,7425,14866,8.4
1997-12-01,4.7,124549,19766,104783,24184,100365,5938,17587,24903,7400,14801,8.5
1997-11-01,4.6,124226,19761,104465,24111,100115,5899,17556,24862,7370,14711,8.4
1997-10-01,4.7,123924,19738,104186,24055,99869,5883,17514,24806,7343,14624,8.5
1997-09-01,4.9,123575,19679,103896,23996,99579,5874,17465,24737,7313,14556,8.7
1997-08-01,4.8,123086,19617,103469,23953,99133,5846,17453,24543,7291,14477,8.7
1997-07-01,4.9,123114,19686,103428,23861,99253,5817,17388,24653,7266,14466,8.7
1997-06-01,5.0,122816,19660,103156,23834,98982,5793,17387,24618,7230,14378,8.9
1997-05-01,4.9,122560,19601,102959,23811,98749,5793,17364,24582,7215,14308,8.9
1997-04-01,5.1,122288,19603,102685,23767,98521,5764,17351,24552,7194,14233,9.3
1997-03-01,5.2,121991,19608,102383,23739,98252,5751,17340,24514,7164,14123,9.1
1997-02-01,5.2,121674,19598,102076,23684,97990,5722,17315,24458,7144,14024,9.3
1997-01-01,5.3,121357,19593,101764,23618,97739,5675,17297,24432,7126,13911,9.4
1996-12-01,5.4,121143,19571,101572,23599,97544,5675,17284,24425,7111,13847,9.6
1996-11-01,5.4,120947,19565,101382,23584,97363,5668,17277,24387,7097,13784,9.4
1996-10-01,5.2,120665,19554,101111,23546,97119,5643,17268,24354,7079,13683,9.5
1996-09-01,5.2,120400,19567,100833,23496,96904,5610,17251,24280,7066,13661,9.5
1996-08-01,5.1,120198,19504,100694,23479,96719,5586,17256,24255,7048,13619,9.4
1996-07-01,5.5,120019,19547,100472,23417,96602,5557,17222,24228,7033,13548,9.7
1996-06-01,5.3,119770,19528,100242,23399,96371,5534,17226,24182,7012,13490,9.7
1996-05-01,5.6,119496,19529,99967,23358,96138,5498,17222,24127,6990,13416,9.8
1996-04-01,5.6,119158,19515,99643,23316,95842,5474,17204,24027,6967,13358,10.0
1996-03-01,5.5,118992,19532,99460,23276,95716,5446,17193,24014,6952,13320,9.9
1996-02-01,5.5,118737,19485,99252,23281,95456,5415,17230,23972,6944,13269,10.0
1996-01-01,5.6,118317,19450,98867,23196,95121,5355,17208,23935,6922,13137,9.8
1995-12-01,5.6,118325,19466,98859,23210,95115,5344,17231,23933,6911,13150,10.0
1995-11-01,5.6,118165,19463,98702,23200,94965,5358,17208,23917,6903,13099,10.1
1995-10-01,5.5,118026,19464,98562,23206,94820,5353,17216,23885,6887,13062,10.0
1995-09-01,5.6,117873,19430,98443,23208,94665,5324,17247,23851,6877,13031,10.2
1995-08-01,5.7,117646,19429,98217,23164,94482,5286,17240,23829,6864,12945,10.1
1995-07-01,5.7,117382,19437,97945,23119,94263,5262,17218,23780,6854,12871,10.1
1995-06-01,5.6,117291,19445,97846,23137,94154,5250,17247,23777,6847,12828,10.1
1995-05-01,5.6,117047,19418,97629,23119,93928,5220,17258,23725,6845,12783,10.1
1995-04-01,5.8,117065,19434,97631,23174,93891,5252,17278,23726,6846,12779,10.1
1995-03-01,5.4,116908,19427,97481,23151,93757,5242,17263,23667,6854,12765,9.9
1995-02-01,5.4,116694,19407,97287,23105,93589,5192,17266,23672,6850,12722,9.9
1995-01-01,5.6,116505,19397,97108,23147,93358,5234,17262,23616,6858,12662,10.1
1994-12-01,5.5,116173,19388,96785,23096,93077,5226,17218,23549,6868,12582,10.1
1994-11-01,5.6,115868,19367,96501,23049,92819,5210,17186,23465,6878,12540,10.1
1994-10-01,5.8,115457,19344,96113,22974,92483,5177,17144,23361,6889,12448,10.4
1994-09-01,5.9,115247,19337,95910,22947,92300,5175,17114,23293,6906,12394,10.4
1994-08-01,6.0,114903,19306,95597,22876,92027,5139,17081,23201,6920,12314,10.6
1994-07-01,6.1,114608,19301,95307,22807,91801,5125,17025,23114,6925,12269,10.8
1994-06-01,6.1,114239,19274,94965,22764,91475,5097,17009,23027,6929,12164,11.0
1994-05-01,6.1,113922,19264,94658,22703,91219,5084,16961,22948,6928,12093,10.9
1994-04-01,6.4,113589,19223,94366,22641,90948,5047,16933,22833,6936,12047,11.3
1994-03-01,6.5,113245,19190,94055,22550,90695,4990,16897,22815,6930,11964,11.5
1994-02-01,6.6,112782,19150,93632,22451,90331,4923,16862,22710,6910,11881,11.4
1994-01-01,6.6,112601,19147,93454,22465,90136,4940,16855,22613,6889,11835,11.7
1993-12-01,6.5,112324,19109,93215,22413,89911,4925,16815,22574,6869,11795,
1993-11-01,6.6,111988,19068,92920,22346,89642,4887,16800,22512,6846,11758,
1993-10-01,6.8,111734,19042,92692,22305,89429,4868,16778,22482,6819,11707,
1993-09-01,6.7,111449,19041,92408,22253,89196,4823,16770,22429,6796,11629,
1993-08-01,6.8,111200,19028,92172,22202,88998,4806,16740,22376,6770,11575,
1993-07-01,6.9,111054,19060,91994,22184,88870,4783,16740,22364,6751,11536,
1993-06-01,7.0,110742,18969,91773,22166,88576,4760,16742,22307,6724,11499,
1993-05-01,7.1,110571,18951,91620,22190,88381,4753,16766,22257,6703,11462,
1993-04-01,7.1,110300,18938,91362,22131,88169,4690,16772,22209,6680,11417,
1993-03-01,7.0,110004,18907,91097,22142,87862,4676,16795,22181,6655,11368,
1993-02-01,7.1,110048,18902,91146,22188,87860,4714,16804,22196,6646,11333,
1993-01-01,7.3,109790,18901,90889,22131,87659,4664,16790,22147,6634,11286,
1992-12-01,7.4,109502,18878,90624,22076,87426,4630,16770,22086,6617,11235,
1992-11-01,7.4,109283,18841,90442,22041,87242,4606,16758,22069,6600,11169,
1992-10-01,7.3,109138,18828,90310,22029,87109,4600,16751,22064,6588,11124,
1992-09-01,7.6,108952,18829,90123,22019,86933,4584,16760,22046,6580,11080,
1992-08-01,7.6,108916,18883,90033,22044,86872,4581,16782,22051,6564,11046,
1992-07-01,7.7,108792,18817,89975,22075,86717,4570,16820,22067,6552,11004,
1992-06-01,7.8,108707,18762,89945,22098,86609,4584,16826,22107,6554,10998,
1992-05-01,7.6,108647,18753,89894,22135,86512,4605,16835,22103,6545,10966,
1992-04-01,7.4,108517,18739,89778,22131,86386,4603,16830,22115,6534,10907,
1992-03-01,7.4,108367,18715,89652,22126,86241,4621,16805,22107,6523,10863,
1992-02-01,7.4,108313,18689,89624,22141,86172,4612,16828,22107,6524,10829,
1992-01-01,7.3,108365,18688,89677,22213,86152,4667,16839,22104,6520,10812,
1991-12-01,7.3,108330,18641,89689,22274,86056,4647,16917,22142,6529,10795,
1991-11-01,7.0,108300,18627,89673,22316,85984,4640,16961,22145,6533,10777,
1991-10-01,7.0,108361,18593,89768,22419,85942,4698,16999,22163,6532,10780,
1991-09-01,6.9,108335,18543,89792,22467,85868,4728,17010,22185,6534,10775,
1991-08-01,6.9,108299,18567,89732,22494,85805,4733,17026,22208,6542,10740,
1991-07-01,6.8,108290,18598,89692,22508,85782,4752,17015,22213,6548,10715,
1991-06-01,6.9,108330,18561,89769,22573,85757,4782,17045,22211,6560,10716,
1991-05-01,6.9,108253,18498,89755,22619,85634,4800,17071,22227,6566,10697,
1991-04-01,6.7,108350,18485,89865,22687,85663,4842,17093,22247,6583,10716,
1991-03-01,6.8,108568,18488,90080,22777,85791,4881,17140,22328,6602,10729,
1991-02-01,6.6,108735,18482,90253,22901,85834,4929,17213,22379,6601,10769,
1991-01-01,6.4,109058,18474,90584,23061,85997,4972,17330,22483,6611,10814,
1990-12-01,6.3,109168,18468,90700,23202,85966,5047,17395,22553,6602,10801,
1990-11-01,6.2,109222,18450,90772,23284,85938,5095,17428,22559,6614,10833,
1990-10-01,5.9,109377,18443,90934,23474,85903,5134,17577,22581,6623,10852,
1990-09-01,5.9,109523,18437,91086,23572,85951,5197,17609,22594,6628,10898,
1990-08-01,5.7,109606,18457,91149,23649,85957,5234,17650,22605,6633,10912,
1990-07-01,5.5,109815,18560,91255,23746,86069,5274,17703,22644,6631,10929,
1990-06-01,5.2,109850,18556,91294,23849,86001,5303,17775,22660,6626,10923,
1990-05-01,5.4,109828,18599,91229,23887,85941,5321,17796,22667,6616,10909,
1990-04-01,5.4,109674,18377,91297,23966,85708,5355,17845,22675,6611,10919,
1990-03-01,5.2,109640,18294,91346,24021,85619,5392,17868,22673,6601,10920,
1990-02-01,5.3,109436,18177,91259,24069,85367,5416,17893,22672,6599,10886,
1990-01-01,5.4,109196,18151,91045,23981,85215,5422,17797,22692,6585,10821,
1989-12-01,5.4,108836,18075,90761,23949,84887,5309,17881,22503,6585,10764,
1989-11-01,5.4,108752,18057,90695,24009,84743,5364,17886,22551,6584,10724,
1989-10-01,5.3,108476,18033,90443,23997,84479,5347,17895,22535,6576,10658,
1989-09-01,5.3,108369,18027,90342,24000,84369,5323,17922,22555,6577,10647,
1989-08-01,5.2,108120,17989,90131,24048,84072,5330,17964,22579,6571,10613,
1989-07-01,5.2,108069,17905,90164,24027,84042,5317,17980,22528,6567,10595,
1989-06-01,5.3,108027,17912,90115,24052,83975,5298,18013,22511,6560,10573,
1989-05-01,5.2,107913,17876,90037,24089,83824,5299,18040,22485,6554,10556,
1989-04-01,5.2,107791,17840,89951,24100,83691,5295,18055,22440,6549,10525,
1989-03-01,5.0,107621,17822,89799,24069,83552,5260,18060,22422,6547,10498,
1989-02-01,5.2,107427,17812,89615,24080,83347,5278,18055,22343,6542,10466,
1989-01-01,5.4,107161,17774,89387,24097,83064,5289,18057,22250,6529,10410,
1988-12-01,5.3,106898,17736,89162,24054,82844,5277,18025,22208,6533,10370,
1988-11-01,5.3,106617,17746,88871,24030,82587,5273,18003,22152,6526,10313,
1988-10-01,5.4,106276,17670,88606,23987,82289,5262,17966,22118,6517,10255,
1988-09-01,5.4,106013,17634,88379,23942,82071,5270,17914,22099,6509,10220,
1988-08-01,5.6,105674,17544,88130,23926,81748,5268,17891,22066,6505,10178,
1988-07-01,5.4,105550,17494,88056,23966,81584,5270,17926,22019,6507,10146,
1988-06-01,5.4,105326,17515,87811,23951,81375,5261,17916,21954,6499,10103,
1988-05-01,5.6,104962,17481,87481,23896,81066,5228,17892,21872,6490,10048,
1988-04-01,5.4,104732,17452,87280,23880,80852,5227,17874,21805,6489,10008,
1988-03-01,5.7,104489,17447,87042,23824,80665,5201,17844,21750,6483,9973,
1988-02-01,5.7,104214,17389,86825,23769,80445,5162,17823,21693,6472,9942,
1988-01-01,5.7,103753,17365,86388,23668,80085,5094,17790,21564,6466,9884,
1987-12-01,5.7,103661,17347,86314,23772,79889,5180,17809,21557,6451,9838,
1987-11-01,5.8,103372,17299,86073,23711,79661,5152,17775,21531,6441,9795,
1987-10-01,6.0,103138,17269,85869,23655,79483,5142,17729,21489,6442,9763,
1987-09-01,5.9,102647,17135,85512,23566,79081,5096,17691,21399,6427,9724,
1987-08-01,6.0,102420,17172,85248,23506,78914,5102,17630,21336,6419,9700,
1987-07-01,6.1,102247,17160,85087,23455,78792,5092,17593,21298,6408,9662,
1987-06-01,6.2,101900,17124,84776,23390,78510,5086,17537,21244,6388,9618,
1987-05-01,6.3,101728,17112,84616,23390,78338,5080,17542,21188,6376,9592,
1987-04-01,6.3,101499,17109,84390,23342,78157,5053,17525,21159,6358,9549,
1987-03-01,6.6,101164,17064,84100,23307,77857,5039,17507,21081,6327,9507,
1987-02-01,6.6,100919,17036,83883,23296,77623,5038,17499,21018,6303,9473,
1987-01-01,6.6,100678,17045,83633,23232,77446,5007,17465,20964,6282,9439,
1986-12-01,6.6,100509,17021,83488,23237,77272,4993,17478,20962,6264,9399,
1986-11-01,6.9,100308,17005,83303,23204,77104,4960,17472,20946,6236,9366,
1986-10-01,7.0,100121,16969,83152,23208,76913,4954,17477,20919,6215,9335,
1986-09-01,7.0,99934,16910,83024,23216,76718,4939,17498,20899,6197,9305,
1986-08-01,6.9,99588,16800,82788,23225,76363,4943,17489,20851,6173,9276,
1986-07-01,7.0,99473,16779,82694,23235,76238,4930,17497,20805,6149,9247,
1986-06-01,7.2,99155,16779,82376,23263,75892,4917,17530,20699,6118,9218,
1986-05-01,7.2,99248,16790,82458,23349,75899,4924,17593,20711,6091,9198,
1986-04-01,7.1,99121,16765,82356,23427,75694,4950,17616,20651,6066,9174,
1986-03-01,7.2,98934,16755,82179,23428,75506,4914,17624,20609,6036,9143,
1986-02-01,7.2,98847,16759,82088,23485,75362,4904,17663,20569,6010,9123,
1986-01-01,6.7,98732,16715,82017,23530,75202,4908,17686,20566,5977,9099,
1985-12-01,7.0,98609,16694,81915,23518,75091,4887,17693,20557,5959,9083,
1985-11-01,7.0,98443,16674,81769,23520,74923,4879,17697,20528,5935,9055,
1985-10-01,7.1,98233,16654,81579,23529,74704,4868,17708,20494,5902,9017,
1985-09-01,7.1,98045,16638,81407,23528,74517,4852,17718,20465,5874,8983,
1985-08-01,7.1,97840,16619,81221,23546,74294,4823,17756,20426,5845,8944,
1985-07-01,7.4,97648,16620,81028,23549,74099,4799,17776,20391,5818,8897,
1985-06-01,7.4,97459,16498,80961,23592,73867,4789,17819,20375,5796,8880,
1985-05-01,7.2,97312,16474,80838,23632,73680,4787,17855,20326,5775,8854,
1985-04-01,7.3,97038,16430,80608,23644,73394,4764,17886,20253,5751,8815,
1985-03-01,7.2,96842,16395,80447,23661,73181,4730,17939,20198,5730,8792,
1985-02-01,7.2,96503,16349,80154,23621,72882,4662,17966,20110,5705,8751,
1985-01-01,7.3,96372,16336,80036,23672,72700,4668,18009,20073,5684,8722,
1984-12-01,7.3,96107,16282,79825,23673,72434,4652,18023,20030,5661,8678,
1984-11-01,7.2,95982,16311,79671,23639,72343,4617,18016,20015,5641,8649,
1984-10-01,7.4,95629,16274,79355,23626,72003,4590,18024,19890,5620,8615,
1984-09-01,7.3,95344,16255,79089,23617,71727,4576,18019,19800,5595,8581,
1984-08-01,7.5,95032,16224,78808,23608,71424,4547,18034,19721,5574,8533,
1984-07-01,7.5,94789,16172,78617,23571,71218,4534,18013,19664,5556,8507,
1984-06-01,7.2,94479,16127,78352,23497,70982,4507,17967,19584,5540,8483,
1984-05-01,7.4,94098,16103,77995,23389,70709,4456,17916,19487,5522,8447,
1984-04-01,7.7,93792,16075,77717,23305,70487,4423,17872,19436,5503,8410,
1984-03-01,7.8,93429,16030,77399,23209,70220,4393,17806,19360,5492,8371,
1984-02-01,7.8,93157,16025,77132,23146,70011,4410,17728,19291,5472,8337,
1984-01-01,8.0,92673,16010,76663,22942,69731,4305,17630,19201,5452,8293,
1983-12-01,8.3,92230,16008,76222,22803,69427,4248,17551,19050,5436,8259,
1983-11-01,8.5,91875,15997,75878,22698,69177,4217,17479,18969,5416,8219,
1983-10-01,8.8,91520,15986,75534,22546,68974,4178,17367,18903,5397,8190,
1983-09-01,9.2,91247,16042,75205,22381,68866,4138,17255,18839,5387,8167,
1983-08-01,9.5,90129,16016,74113,22207,67922,4100,17118,18690,5362,8119,
1983-07-01,9.4,90437,16011,74426,22103,68334,4055,17059,18658,5340,8088,
1983-06-01,10.1,90021,16020,74001,21949,68072,4006,16960,18572,5313,8044,
1983-05-01,10.1,89644,16005,73639,21829,67815,3960,16885,18496,5302,8001,
1983-04-01,10.2,89364,15990,73374,21729,67635,3948,16794,18441,5289,7972,
1983-03-01,10.3,89090,16005,73085,21649,67441,3942,16711,18384,5267,7934,
1983-02-01,10.4,88917,16004,72913,21676,67241,3964,16706,18339,5256,7893,
1983-01-01,10.4,88990,16023,72967,21757,67233,4021,16705,18342,5242,7890,
1982-12-01,10.8,88771,15981,72790,21688,67083,3948,16690,18307,5229,7877,
1982-11-01,10.8,88786,15977,72809,21736,67050,3947,16722,18315,5224,7870,
1982-10-01,10.4,88907,15956,72951,21879,67028,3940,16853,18351,5217,7861,
1982-09-01,10.1,89183,15923,73260,22146,67037,3962,17074,18386,5216,7867,
1982-08-01,9.8,89363,15930,73433,22268,67095,3977,17160,18427,5211,7872,
1982-07-01,9.8,89521,15890,73631,22434,67087,4001,17278,18453,5211,7876,
1982-06-01,9.6,89865,16016,73849,22643,67222,4030,17430,18475,5209,7875,
1982-05-01,9.4,90107,16003,74104,22884,67223,4092,17588,18494,5202,7880,
1982-04-01,9.3,90150,16010,74140,22996,67154,4083,17683,18465,5198,7870,
1982-03-01,9.0,90434,16024,74410,23214,67220,4108,17857,18491,5199,7884,
1982-02-01,8.9,90563,16011,74552,23361,67202,4131,17981,18497,5192,7884,
1982-01-01,8.6,90565,16041,74524,23362,67203,4069,18047,18492,5190,7880,
1981-12-01,8.5,90895,16073,74822,23656,67239,4177,18223,18517,5188,7876,
1981-11-01,8.3,91171,16078,75093,23875,67296,4209,18409,18568,5184,7876,
1981-10-01,7.9,91380,16069,75311,24051,67329,4238,18566,18611,5183,7873,
1981-09-01,7.6,91477,16031,75446,24210,67267,4254,18712,18633,5184,7857,
1981-08-01,7.4,91565,16110,75455,24258,67307,4278,18748,18648,5181,7841,
1981-07-01,7.2,91601,16175,75426,24302,67299,4299,18785,18639,5174,7824,
1981-06-01,7.5,91490,16159,75331,24290,67200,4311,18789,18619,5163,7806,
1981-05-01,7.5,91296,16198,75098,24148,67148,4343,18766,18595,5160,7785,
1981-04-01,7.2,91283,16260,75023,24151,67132,4414,18711,18580,5151,7768,
1981-03-01,7.4,91210,16292,74918,24203,67007,4396,18647,18527,5137,7744,
1981-02-01,7.4,91105,16346,74759,24118,66987,4357,18613,18506,5128,7730,
1981-01-01,7.5,91033,16360,74673,24152,66881,4374,18639,18462,5116,7714,
1980-12-01,7.2,90943,16373,74570,24182,66761,4415,18640,18429,5100,7691,
1980-11-01,7.5,90747,16391,74356,24123,66624,4409,18601,18391,5085,7660,
1980-10-01,7.5,90490,16386,74104,24012,66478,4411,18506,18363,5071,7629,
1980-09-01,7.5,90213,16330,73883,23931,66282,4401,18445,18343,5051,7605,
1980-08-01,7.7,90099,16410,73689,23860,66239,4377,18414,18318,5039,7576,
1980-07-01,7.8,89840,16418,73422,23698,66142,4351,18276,18285,5027,7548,
1980-06-01,7.6,90101,16441,73660,23968,66133,4395,18490,18306,5016,7534,
1980-05-01,7.5,90420,16454,73966,24234,66186,4434,18726,18356,5004,7534,
1980-04-01,6.9,90849,16583,74266,24507,66342,4473,18973,18395,4993,7533,
1980-03-01,6.3,90994,16296,74698,24818,66176,4548,19217,18495,4987,7536,
1980-02-01,6.3,90883,16226,74657,24874,66009,4605,19219,18491,4969,7512,
1980-01-01,6.3,90800,16201,74599,24949,65851,4625,19282,18456,4956,7488,
1979-12-01,6.0,90672,16180,74492,24970,65702,4630,19301,18438,4933,7459,
1979-11-01,5.9,90573,16173,74400,24947,65626,4617,19299,18454,4920,7436,
1979-10-01,6.0,90481,16136,74345,25038,65443,4620,19390,18390,4903,7421,
1979-09-01,5.9,90327,16128,74199,25088,65239,4625,19442,18316,4884,7395,
1979-08-01,6.0,90300,16229,74071,25059,65241,4634,19406,18281,4885,7378,
1979-07-01,5.7,90217,16150,74067,25163,65054,4621,19531,18267,4856,7360,
1979-06-01,5.7,90108,16045,74063,25161,64947,4604,19553,18294,4840,7346,
1979-05-01,5.6,89789,15990,73799,25071,64718,4565,19509,18237,4821,7313,
1979-04-01,5.8,89417,15977,73440,24958,64459,4516,19450,18143,4796,7271,
1979-03-01,5.8,89479,15956,73523,24998,64481,4552,19453,18214,4776,7265,
1979-02-01,5.9,89055,15947,73108,24784,64271,4389,19409,18157,4757,7228,
1979-01-01,5.9,88808,15937,72871,24740,64068,4373,19388,18107,4738,7191,
1978-12-01,6.0,88671,15911,72760,24758,63913,4450,19334,18047,4717,7178,
1978-11-01,5.9,88391,15894,72497,24678,63713,4453,19257,17985,4697,7147,
1978-10-01,5.8,87956,15858,72098,24548,63408,4447,19142,17894,4665,7105,
1978-09-01,6.0,87621,15819,71802,24444,63177,4424,19068,17795,4650,7083,
1978-08-01,5.9,87483,15891,71592,24374,63109,4420,19006,17738,4633,7062,
1978-07-01,6.2,87204,15901,71303,24300,62904,4403,18951,17672,4615,7022,
1978-06-01,5.9,86950,15852,71098,24238,62712,4379,18919,17648,4592,6993,
1978-05-01,6.0,86509,15834,70675,24082,62427,4302,18848,17541,4566,6957,
1978-04-01,6.1,86162,15797,70365,24008,62154,4308,18772,17452,4547,6921,
1978-03-01,6.3,85460,15731,69729,23649,61811,4178,18699,17351,4527,6873,
1978-02-01,6.3,84948,15671,69277,23453,61495,4058,18639,17264,4506,6830,
1978-01-01,6.4,84594,15611,68983,23374,61220,4029,18593,17198,4476,6794,
1977-12-01,6.4,84410,15538,68872,23371,61039,4087,18531,17138,4461,6787,
1977-11-01,6.8,84173,15515,68658,23371,60802,4058,18419,17047,4441,6761,
1977-10-01,6.8,83800,15463,68337,23279,60521,4034,18356,16962,4416,6732,
1977-09-01,6.8,83532,15403,68129,23244,60288,4023,18334,16922,4394,6697,
1977-08-01,7.0,83075,15328,67747,23124,59951,3995,18276,16834,4368,6653,
1977-07-01,6.9,82834,15299,67535,23106,59728,3981,18259,16772,4349,6621,
1977-06-01,7.2,82488,15207,67281,23046,59442,3962,18192,16709,4333,6587,
1977-05-01,7.0,82088,15132,66956,22919,59169,3930,18107,16638,4318,6556,
1977-04-01,7.2,81728,15075,66653,22807,58921,3904,18024,16567,4304,6526,
1977-03-01,7.4,81391,15050,66341,22672,58719,3859,17941,16501,4285,6500,
1977-02-01,7.6,80988,15056,65932,22478,58510,3775,17843,16424,4260,6470,
1977-01-01,7.5,80690,15056,65634,22320,58370,3660,17803,16375,4247,6447,
1976-12-01,7.8,80448,15075,65373,22261,58187,3688,17719,16294,4229,6419,
1976-11-01,7.8,80240,15073,65167,22207,58033,3678,17682,16242,4213,6395,
1976-10-01,7.7,79911,15028,64883,22037,57874,3645,17548,16219,4199,6373,
1976-09-01,7.6,79892,14971,64921,22142,57750,3634,17665,16216,4184,6355,
1976-08-01,7.8,79704,15007,64697,22038,57666,3632,17596,16169,4160,6340,
1976-07-01,7.8,79547,14993,64554,21988,57559,3627,17524,16132,4155,6327,
1976-06-01,7.6,79376,14963,64413,21982,57394,3632,17521,16090,4146,6304,
1976-05-01,7.4,79312,14971,64341,21988,57324,3649,17513,16080,4136,6286,
1976-04-01,7.7,79292,14985,64307,22050,57242,3684,17541,16055,4127,6267,
1976-03-01,7.6,79048,14987,64061,21980,57068,3685,17470,15980,4115,6246,
1976-02-01,7.7,78816,14981,63835,21893,56923,3687,17384,15947,4105,6217,
1976-01-01,7.9,78503,14969,63534,21799,56704,3688,17287,15852,4096,6191,
1975-12-01,8.2,78017,14946,63071,21602,56415,3641,17140,15735,4090,6152,
1975-11-01,8.3,77685,14903,62782,21442,56243,3604,17025,15700,4076,6130,
1975-10-01,8.4,77540,14900,62640,21384,56156,3587,16984,15670,4072,6120,
1975-09-01,8.4,77228,14824,62404,21284,55944,3573,16904,15634,4062,6088,
1975-08-01,8.4,77153,14870,62283,21176,55977,3547,16824,15617,4052,6091,
1975-07-01,8.6,76770,14861,61909,20981,55789,3501,16678,15567,4042,6055,
1975-06-01,8.8,76521,14784,61737,21018,55503,3526,16690,15522,4031,6011,
1975-05-01,9.0,76624,14827,61797,21097,55527,3552,16746,15493,4032,6022,
1975-04-01,8.8,76460,14795,61665,21109,55351,3565,16759,15454,4027,5994,
1975-03-01,8.6,76648,14754,61894,21274,55374,3628,16853,15502,4024,5999,
1975-02-01,8.1,76918,14747,62171,21512,55406,3718,17004,15538,4026,6002,
1975-01-01,8.1,77293,14624,62669,21974,55319,3841,17344,15574,4031,6006,
1974-12-01,7.2,77652,14559,63093,22303,55349,3860,17693,15625,4036,6020,
1974-11-01,6.6,78265,14532,63733,22773,55492,3911,18077,15727,4038,6039,
1974-10-01,6.0,78630,14484,64146,23118,55512,3972,18364,15767,4038,6049,
1974-09-01,5.9,78610,14422,64188,23274,55336,4009,18492,15725,4036,6028,
1974-08-01,5.5,78619,14328,64291,23396,55223,4059,18570,15723,4035,6029,
1974-07-01,5.5,78636,14288,64348,23462,55174,4045,18656,15727,4034,6023,
1974-06-01,5.4,78604,14239,64365,23591,55013,4146,18690,15691,4030,6007,
1974-05-01,5.1,78549,14221,64328,23635,54914,4198,18688,15672,4022,5990,
1974-04-01,5.1,78382,14191,64191,23670,54712,4225,18702,15629,4012,5954,
1974-03-01,5.1,78296,14152,64144,23687,54609,4255,18700,15595,4006,5952,
1974-02-01,5.2,78254,14135,64119,23718,54536,4259,18727,15586,4004,5940,
1974-01-01,5.1,78100,14090,64010,23709,54391,4196,18788,15563,3986,5920,
1973-12-01,4.9,78031,14070,63961,23779,54252,4239,18820,15503,3972,5904,
1973-11-01,4.8,77920,14035,63885,23719,54201,4232,18773,15512,3963,5897,
1973-10-01,4.6,77607,13977,63630,23641,53966,4232,18702,15460,3947,5866,
1973-09-01,4.8,77276,13892,63384,23548,53728,4237,18609,15396,3946,5837,
1973-08-01,4.8,77168,13904,63264,23559,53609,4233,18629,15369,3939,5811,
1973-07-01,4.8,76913,13865,63048,23522,53391,4232,18598,15330,3929,5768,
1973-06-01,4.9,76887,13872,63015,23485,53402,4193,18606,15320,3918,5777,
1973-05-01,4.9,76648,13817,62831,23382,53266,4137,18564,15284,3909,5765,
1973-04-01,5.0,76455,13777,62678,23316,53139,4106,18530,15245,3897,5755,
1973-03-01,4.9,76284,13745,62539,23262,53022,4089,18493,15212,3888,5744,
1973-02-01,5.0,76014,13711,62303,23160,52854,4071,18410,15164,3874,5723,
1973-01-01,4.9,75617,13690,61927,22955,52662,4004,18276,15102,3852,5697,
1972-12-01,5.2,75268,13684,61584,22772,52496,3937,18158,15047,3842,5668,
1972-11-01,5.3,74973,13643,61330,22688,52285,4002,18005,14974,3832,5646,
1972-10-01,5.6,74674,13606,61068,22613,52061,4038,17893,14899,3821,5619,
1972-09-01,5.5,74264,13575,60689,22456,51808,4000,17774,14831,3810,5574,
1972-08-01,5.6,74141,13530,60611,22400,51741,3983,17741,14812,3801,5578,
1972-07-01,5.6,73709,13482,60227,22162,51547,3939,17556,14764,3790,5551,
1972-06-01,5.7,73758,13405,60353,22282,51476,3969,17641,14758,3791,5561,
1972-05-01,5.7,73469,13416,60053,22222,51247,3957,17602,14699,3765,5511,
1972-04-01,5.7,73162,13358,59804,22099,51063,3931,17508,14669,3753,5485,
1972-03-01,5.8,72944,13329,59615,22036,50908,3921,17447,14635,3740,5462,
1972-02-01,5.7,72648,13298,59350,21915,50733,3888,17361,14573,3730,5441,
1972-01-01,5.8,72441,13266,59175,21865,50576,3912,17283,14520,3723,5426,
1971-12-01,6.0,72109,13190,58919,21741,50368,3867,17202,14462,3716,5409,
1971-11-01,6.0,71847,13148,58699,21684,50163,3903,17166,14380,3704,5393,
1971-10-01,5.8,71642,13115,58527,21604,50038,3867,17126,14355,3690,5376,
1971-09-01,6.0,71614,13068,58546,21650,49964,3820,17154,14367,3679,5364,
1971-08-01,6.1,71373,13041,58332,21570,49803,3786,17115,14320,3666,5344,
1971-07-01,6.0,71315,13011,58304,21564,49751,3786,17126,14295,3658,5351,
1971-06-01,5.9,71254,13008,58246,21568,49686,3759,17139,14272,3652,5346,
1971-05-01,5.9,71247,12970,58277,21645,49602,3750,17225,14279,3632,5334,
1971-04-01,5.9,71036,12945,58091,21552,49484,3735,17149,14244,3620,5322,
1971-03-01,6.0,70860,12908,57952,21491,49369,3674,17154,14209,3607,5315,
1971-02-01,5.9,70807,12877,57930,21514,49293,3633,17216,14203,3599,5309,
1971-01-01,5.9,70865,12878,57987,21594,49271,3643,17280,14184,3591,5313,
1970-12-01,6.1,70792,12845,57947,21673,49119,3688,17309,14130,3579,5303,
1970-11-01,5.9,70409,12830,57579,21345,49064,3643,17024,14133,3568,5295,
1970-10-01,5.5,70521,12793,57728,21477,49044,3626,17173,14160,3556,5294,
1970-09-01,5.4,70944,12741,58203,21988,48956,3618,17692,14153,3548,5289,
1970-08-01,5.1,70937,12711,58226,22105,48832,3649,17779,14146,3538,5272,
1970-07-01,5.0,71053,12697,58356,22195,48858,3645,17877,14156,3534,5284,
1970-06-01,4.9,71029,12667,58362,22241,48788,3636,17930,14119,3528,5286,
1970-05-01,4.8,71124,12668,58456,22336,48788,3634,18029,14108,3525,5289,
1970-04-01,4.6,71348,12705,58643,22552,48796,3669,18207,14101,3519,5289,
1970-03-01,4.4,71451,12603,58848,22738,48713,3697,18360,14124,3512,5287,
1970-02-01,4.2,71305,12518,58787,22747,48558,3703,18361,14097,3497,5283,
1970-01-01,3.9,71176,12496,58680,22726,48450,3615,18424,14076,3485,5271,
1969-12-01,3.5,71241,12477,58764,22884,48357,3707,18485,14057,3472,5258,
1969-11-01,3.5,71086,12448,58638,22840,48246,3683,18467,14029,3459,5245,
1969-10-01,3.7,71121,12430,58691,22976,48145,3672,18613,13982,3448,5242,
1969-09-01,3.7,70914,12379,58535,22988,47926,3676,18620,13931,3438,5207,
1969-08-01,3.5,71008,12373,58635,23111,47897,3654,18767,13915,3435,5211,
1969-07-01,3.5,70729,12340,58389,22990,47739,3664,18642,13873,3417,5192,
1969-06-01,3.5,70636,12359,58277,22981,47655,3664,18640,13848,3401,5174,
1969-05-01,3.4,70328,12284,58044,22899,47429,3635,18588,13781,3383,5154,
1969-04-01,3.4,70072,12245,57827,22815,47257,3590,18554,13728,3371,5139,
1969-03-01,3.4,69905,12229,57676,22813,47092,3579,18558,13664,3355,5118,
1969-02-01,3.4,69699,12224,57475,22755,46944,3575,18502,13624,3342,5092,
1969-01-01,3.4,69439,12209,57230,22644,46795,3534,18432,13580,3326,5073,
1968-12-01,3.4,69248,12145,57103,22617,46631,3526,18410,13563,3310,5053,
1968-11-01,3.4,68984,12107,56877,22512,46472,3486,18346,13524,3298,5032,
1968-10-01,3.4,68721,12101,56620,22419,46302,3490,18293,13476,3283,5001,
1968-09-01,3.4,68484,12067,56417,22390,46094,3457,18252,13429,3264,4965,
1968-08-01,3.5,68330,12042,56288,22350,45980,3417,18254,13383,3253,4962,
1968-07-01,3.7,68126,12018,56108,22329,45797,3386,18265,13320,3231,4944,
1968-06-01,3.7,67905,11987,55918,22264,45641,3363,18228,13278,3215,4924,
1968-05-01,3.5,67652,11905,55747,22255,45397,3390,18190,13211,3210,4895,
1968-04-01,3.5,67556,11878,55678,22207,45349,3401,18131,13238,3200,4887,
1968-03-01,3.7,67295,11842,55453,22119,45176,3388,18067,13165,3191,4873,
1968-02-01,3.8,67215,11819,55396,22117,45098,3397,18054,13146,3182,4866,
1968-01-01,3.7,66804,11794,55010,21917,44887,3211,18040,13060,3169,4845,
1967-12-01,3.8,66900,11735,55165,22037,44863,3345,18025,13107,3161,4839,
1967-11-01,3.9,66703,11695,55008,21996,44707,3344,17985,13066,3146,4824,
1967-10-01,4.0,66225,11642,54583,21779,44446,3313,17800,12992,3133,4788,
1967-09-01,3.8,66164,11623,54541,21775,44389,3314,17794,12992,3123,4777,
1967-08-01,3.8,66143,11590,54553,21887,44256,3312,17905,12969,3110,4764,
1967-07-01,3.8,65888,11544,54344,21772,44116,3303,17784,12945,3094,4745,
1967-06-01,3.9,65750,11534,54216,21761,43989,3264,17812,12909,3081,4726,
1967-05-01,3.8,65620,11474,54146,21779,43841,3262,17832,12892,3065,4709,
1967-04-01,3.8,65466,11435,54031,21842,43624,3277,17878,12816,3051,4693,
1967-03-01,3.8,65530,11397,54133,21919,43611,3290,17940,12864,3037,4681,
1967-02-01,3.8,65429,11353,54076,21987,43442,3317,17978,12819,3023,4666,
1967-01-01,3.9,65407,11315,54092,22057,43350,3329,18033,12814,3012,4655,
1966-12-01,3.8,65199,11256,53943,22008,43191,3318,17998,12787,3002,4634,
1966-11-01,3.6,65019,11203,53816,21988,43031,3314,17981,12749,2991,4618,
1966-10-01,3.7,64854,11127,53727,21991,42863,3340,17956,12719,2983,4601,
1966-09-01,3.7,64643,11063,53580,21948,42695,3367,17886,12684,2978,4580,
1966-08-01,3.8,64507,11006,53501,21972,42535,3394,17882,12643,2973,4564,
1966-07-01,3.8,64301,10974,53327,21872,42429,3420,17760,12622,2973,4547,
1966-06-01,3.8,64111,10902,53209,21846,42265,3422,17733,12598,2959,4532,
1966-05-01,3.9,63712,10821,52891,21675,42037,3360,17625,12542,2949,4508,
1966-04-01,3.8,63437,10759,52678,21568,41869,3394,17517,12511,2942,4490,
1966-03-01,3.8,63192,10692,52500,21515,41677,3421,17400,12456,2936,4470,
1966-02-01,3.8,62796,10611,52185,21315,41481,3336,17288,12418,2924,4450,
1966-01-01,4.0,62529,10541,51988,21214,41315,3379,17143,12385,2921,4433,
1965-12-01,4.0,62322,10499,51823,21151,41171,3406,17051,12343,2915,4416,
1965-11-01,4.1,61996,10436,51560,21021,40975,3365,16962,12293,2910,4394,
1965-10-01,4.2,61719,10378,51341,20895,40824,3340,16864,12260,2904,4380,
1965-09-01,4.3,61490,10338,51152,20808,40682,3320,16802,12219,2894,4365,
1965-08-01,4.4,61228,10271,50957,20726,40502,3303,16732,12176,2886,4347,
1965-07-01,4.4,60965,10201,50764,20611,40354,3249,16669,12143,2880,4334,
1965-06-01,4.6,60690,10128,50562,20522,40168,3279,16554,12110,2871,4313,
1965-05-01,4.6,60491,10094,50397,20444,40047,3269,16477,12072,2868,4299,
1965-04-01,4.8,60259,10051,50208,20317,39942,3200,16418,12067,2860,4284,
1965-03-01,4.7,60003,10010,49993,20292,39711,3241,16353,11970,2855,4264,
1965-02-01,5.1,59800,9974,49826,20216,39584,3225,16291,11929,2849,4250,
1965-01-01,4.9,59582,9937,49645,20173,39409,3231,16245,11864,2844,4233,
1964-12-01,5.0,59421,9897,49524,20111,39310,3233,16176,11847,2837,4222,
1964-11-01,4.8,59218,9879,49339,20026,39192,3226,16096,11801,2833,4211,
1964-10-01,5.1,58793,9845,48948,19723,39070,3200,15821,11764,2828,4197,
1964-09-01,5.1,58903,9786,49117,19943,38960,3171,16073,11731,2826,4197,
1964-08-01,5.0,58619,9732,48887,19810,38809,3166,15948,11708,2819,4174,
1964-07-01,4.9,58412,9677,48735,19740,38672,3157,15887,11670,2816,4162,
1964-06-01,5.2,58219,9669,48550,19682,38537,3147,15839,11616,2810,4144,
1964-05-01,5.1,58089,9670,48419,19630,38459,3125,15812,11588,2806,4133,
1964-04-01,5.3,57922,9644,48278,19593,38329,3113,15785,11554,2801,4118,
1964-03-01,5.4,57897,9611,48286,19587,38310,3125,15770,11588,2793,4102,
1964-02-01,5.4,57753,9581,48172,19570,38183,3132,15742,11534,2786,4098,
1964-01-01,5.6,57487,9562,47925,19406,38081,2996,15715,11512,2778,4084,
1963-12-01,5.5,57361,9497,47864,19493,37868,3082,15712,11440,2769,4064,
1963-11-01,5.7,57255,9484,47771,19456,37799,3083,15675,11430,2759,4056,
1963-10-01,5.5,57283,9479,47804,19517,37766,3104,15714,11412,2755,4058,
1963-09-01,5.5,57078,9417,47661,19483,37595,3110,15674,11388,2742,4036,
1963-08-01,5.4,56910,9368,47542,19437,37473,3099,15644,11367,2738,4020,
1963-07-01,5.6,56794,9334,47460,19423,37371,3088,15646,11348,2731,4009,
1963-06-01,5.6,56659,9302,47357,19371,37288,3060,15624,11332,2726,4000,
1963-05-01,5.9,56616,9288,47328,19399,37217,3061,15641,11318,2724,3988,
1963-04-01,5.7,56580,9264,47316,19343,37237,3046,15602,11374,2715,3980,
1963-03-01,5.7,56320,9245,47075,19233,37087,2979,15564,11301,2709,3968,
1963-02-01,5.9,56230,9231,46999,19228,37002,2997,15542,11281,2702,3956,
1963-01-01,5.7,56115,9204,46911,19257,36858,3021,15545,11216,2696,3943,
1962-12-01,5.5,56028,9126,46902,19219,36809,3008,15520,11246,2688,3944,
1962-11-01,5.7,56056,9145,46911,19260,36796,3035,15530,11242,2683,3937,
1962-10-01,5.4,56041,9114,46927,19301,36740,3031,15569,11235,2676,3939,
1962-09-01,5.6,55978,9089,46889,19305,36673,3033,15568,11227,2669,3931,
1962-08-01,5.7,55838,9063,46775,19251,36587,3027,15517,11209,2664,3918,
1962-07-01,5.4,55746,9026,46720,19248,36498,3025,15522,11196,2659,3908,
1962-06-01,5.5,55644,9000,46644,19186,36458,2960,15518,11206,2655,3902,
1962-05-01,5.5,55628,8958,46670,19253,36375,3025,15513,11200,2649,3893,
1962-04-01,5.6,55602,8922,46680,19258,36344,3018,15524,11236,2641,3880,
1962-03-01,5.6,55275,8901,46374,19109,36166,2941,15451,11155,2636,3864,
1962-02-01,5.5,55188,8878,46310,19109,36079,2975,15411,11134,2630,3854,
1962-01-01,5.8,54891,8851,46040,18936,35955,2892,15322,11096,2625,3838,
1961-12-01,6.0,54872,8836,46036,18981,35891,2951,15309,11079,2621,3828,
1961-11-01,6.1,54742,8812,45930,18927,35815,2941,15259,11079,2614,3814,
1961-10-01,6.5,54522,8805,45717,18805,35717,2935,15143,11049,2608,3799,
1961-09-01,6.7,54388,8796,45592,18730,35658,2918,15080,11036,2604,3790,
1961-08-01,6.6,54298,8764,45534,18725,35573,2902,15093,11030,2599,3775,
1961-07-01,7.0,54123,8724,45399,18640,35483,2883,15029,11028,2592,3760,
1961-06-01,6.9,53977,8688,45289,18618,35359,2907,14981,10993,2587,3746,
1961-05-01,7.1,53786,8664,45122,18523,35263,2866,14932,10976,2580,3732,
1961-04-01,7.0,53627,8629,44998,18432,35195,2883,14825,10973,2573,3723,
1961-03-01,6.9,53659,8611,45048,18438,35221,2910,14802,11011,2567,3720,
1961-02-01,6.9,53557,8587,44970,18418,35139,2888,14801,10991,2567,3712,
1961-01-01,6.6,53683,8564,45119,18508,35175,2909,14863,11038,2565,3714,
1960-12-01,6.6,53742,8597,45145,18548,35194,2862,14947,11045,2560,3710,
1960-11-01,6.1,53961,8516,45445,18799,35162,2936,15112,11076,2557,3717,
1960-10-01,6.1,54142,8502,45640,18952,35190,2956,15231,11117,2548,3720,
1960-09-01,5.5,54227,8494,45733,19057,35170,2959,15330,11124,2549,3717,
1960-08-01,5.6,54272,8472,45800,19105,35167,2973,15360,11141,2543,3718,
1960-07-01,5.5,54306,8442,45864,19170,35136,3002,15413,11142,2536,3718,
1960-06-01,5.4,54348,8432,45916,19240,35108,2999,15466,11147,2528,3715,
1960-05-01,5.1,54475,8432,46043,19374,35101,3021,15575,11157,2523,3713,
1960-04-01,5.2,54813,8534,46279,19446,35367,3004,15654,11279,2520,3712,
1960-03-01,5.4,54454,8525,45929,19373,35081,2881,15707,11117,2513,3695,
1960-02-01,4.8,54513,8326,46187,19605,34908,3053,15765,11130,2506,3701,
1960-01-01,5.2,54274,8307,45967,19491,34783,3021,15687,11095,2496,3685,
1959-12-01,5.3,54174,8368,45806,19425,34749,3058,15573,11068,2491,3668,
1959-11-01,5.8,53634,8284,45350,19108,34526,3025,15300,11014,2483,3642,
1959-10-01,5.7,53358,8265,45093,18925,34433,3016,15158,10994,2477,3626,
1959-09-01,5.5,53428,8239,45189,19052,34376,3051,15254,10991,2470,3622,
1959-08-01,5.2,53336,8181,45155,19049,34287,3085,15202,11004,2464,3609,
1959-07-01,5.1,53804,8173,45631,19529,34275,3087,15623,10977,2460,3623,
1959-06-01,5.0,53681,8143,45538,19462,34219,3100,15554,10968,2454,3620,
1959-05-01,5.1,53550,8153,45397,19378,34172,3087,15487,10949,2447,3611,
1959-04-01,5.2,53321,8142,45179,19269,34052,3085,15385,10905,2439,3594,
1959-03-01,5.6,53014,8132,44882,19069,33945,3013,15259,10873,2430,3573,
1959-02-01,5.9,52688,8116,44572,18890,33798,2980,15115,10816,2420,3556,
1959-01-01,6.0,52478,8105,44373,18796,33682,2993,14998,10774,2418,3540,
1958-12-01,6.2,52085,8100,43985,18592,33493,2910,14877,10700,2402,3508,
1958-11-01,6.2,51944,8028,43916,18610,33334,2982,14827,10676,2396,3495,
1958-10-01,6.7,51485,8031,43454,18218,33267,2917,14503,10650,2395,3479,
1958-09-01,7.1,51506,8016,43490,18331,33175,2874,14658,10613,2390,3471,
1958-08-01,7.4,51233,8012,43221,18147,33086,2833,14524,10581,2385,3457,
1958-07-01,7.5,51039,7972,43067,18038,33001,2807,14450,10579,2380,3445,
1958-06-01,7.3,50914,7926,42988,17984,32930,2796,14408,10575,2381,3439,
1958-05-01,7.4,50914,7894,43020,18008,32906,2815,14414,10583,2385,3438,
1958-04-01,7.4,51027,7868,43159,18120,32907,2823,14506,10607,2379,3441,
1958-03-01,6.7,51299,7848,43451,18335,32964,2853,14670,10647,2378,3452,
1958-02-01,6.4,51576,7832,43744,18529,33047,2792,14908,10702,2380,3465,
1958-01-01,5.8,52076,7821,44255,18902,33174,2925,15130,10775,2383,3484,
1957-12-01,5.2,52384,7846,44538,19111,33273,2935,15332,10804,2378,3502,
1957-11-01,5.1,52558,7769,44789,19260,33298,2945,15466,10863,2374,3516,
1957-10-01,4.5,52763,7768,44995,19421,33342,2965,15599,10894,2364,3526,
1957-09-01,4.4,52934,7749,45185,19545,33389,2971,15710,10941,2354,3533,
1957-08-01,4.1,53128,7757,45371,19728,33400,2986,15867,10951,2355,3533,
1957-07-01,4.2,53123,7754,45369,19735,33388,3011,15854,10948,2355,3530,
1957-06-01,4.3,53067,7702,45365,19777,33290,3035,15873,10931,2345,3527,
1957-05-01,4.1,53150,7713,45437,19834,33316,3035,15931,10956,2338,3527,
1957-04-01,3.9,53238,7701,45537,19887,33351,3048,15970,11014,2333,3520,
1957-03-01,3.7,53156,7672,45484,19936,33220,3073,15994,10952,2330,3514,
1957-02-01,3.9,53097,7646,45451,19933,33164,3065,15998,10942,2326,3509,
1957-01-01,4.2,52887,7620,45267,19833,33054,2996,15970,10911,2320,3496,
1956-12-01,4.2,52929,7584,45345,19926,33003,3106,15957,10926,2318,3484,
1956-11-01,4.3,52821,7553,45268,19886,32935,3105,15916,10912,2319,3476,
1956-10-01,3.9,52777,7519,45258,19918,32859,3113,15937,10901,2312,3469,
1956-09-01,3.9,52604,7481,45123,19860,32744,3129,15863,10883,2308,3454,
1956-08-01,4.1,52631,7451,45180,19922,32709,3160,15893,10897,2315,3445,
1956-07-01,4.4,51955,7405,44550,19390,32565,3117,15468,10860,2303,3423,
1956-06-01,4.3,52586,7367,45219,19905,32681,3202,15835,10923,2300,3455,
1956-05-01,4.3,52506,7367,45139,19825,32681,3073,15893,10926,2296,3455,
1956-04-01,4.0,52375,7276,45099,19811,32564,3033,15909,10919,2290,3455,
1956-03-01,4.2,52294,7252,45042,19691,32603,2999,15829,10958,2285,3451,
1956-02-01,3.9,52167,7212,44955,19731,32436,2986,15889,10891,2276,3442,
1956-01-01,4.0,51975,7167,44808,19665,32310,2933,15882,10859,2267,3432,
1955-12-01,4.2,51805,7132,44673,19608,32197,2903,15859,10829,2258,3420,
1955-11-01,4.2,51592,7083,44509,19554,32038,2898,15813,10777,2248,3409,
1955-10-01,4.3,51429,7118,44311,19482,31947,2901,15740,10714,2243,3393,
1955-09-01,4.1,51266,7067,44199,19427,31839,2921,15668,10711,2237,3375,
1955-08-01,4.2,51111,7023,44088,19432,31679,2922,15679,10660,2228,3361,
1955-07-01,4.0,50987,7049,43938,19376,31611,2932,15614,10626,2220,3347,
1955-06-01,4.2,50790,7020,43770,19331,31459,2916,15585,10579,2208,3328,
1955-05-01,4.3,50512,6991,43521,19223,31289,2903,15493,10518,2194,3310,
1955-04-01,4.7,50248,6959,43289,19067,31181,2871,15375,10504,2188,3293,
1955-03-01,4.6,49962,6938,43024,18910,31052,2835,15258,10455,2181,3277,
1955-02-01,4.7,49644,6923,42721,18726,30918,2779,15138,10400,2171,3262,
1955-01-01,4.9,49496,6953,42543,18609,30887,2769,15034,10382,2165,3250,
1954-12-01,5.0,49331,6957,42374,18508,30823,2736,14967,10356,2160,3238,
1954-11-01,5.3,49180,6964,42216,18438,30742,2720,14913,10319,2154,3228,
1954-10-01,5.7,48942,6900,42042,18321,30621,2677,14841,10298,2146,3219,
1954-09-01,6.1,48886,6894,41992,18261,30625,2661,14805,10300,2142,3221,
1954-08-01,6.0,48826,6892,41934,18251,30575,2666,14772,10304,2121,3211,
1954-07-01,5.8,48835,6868,41967,18280,30555,2664,14799,10316,2119,3208,
1954-06-01,5.6,48895,6846,42049,18400,30495,2669,14910,10304,2114,3203,
1954-05-01,5.9,48965,6829,42136,18476,30489,2680,14974,10327,2108,3201,
1954-04-01,5.9,49179,6806,42373,18602,30577,2701,15065,10431,2100,3202,
1954-03-01,5.7,49157,6796,42361,18748,30409,2703,15197,10327,2089,3198,
1954-02-01,5.2,49382,6783,42599,18880,30502,2709,15307,10396,2082,3207,
1954-01-01,4.9,49469,6760,42709,18963,30506,2651,15440,10417,2075,3212,
1953-12-01,4.5,49703,6743,42960,19173,30530,2713,15581,10434,2067,3223,
1953-11-01,3.5,49908,6749,43159,19315,30593,2701,15728,10474,2059,3230,
1953-10-01,3.1,50240,6764,43476,19578,30662,2707,15981,10504,2054,3240,
1953-09-01,2.9,50368,6749,43619,19726,30642,2680,16151,10495,2048,3246,
1953-08-01,2.7,50489,6754,43735,19834,30655,2657,16278,10510,2045,3246,
1953-07-01,2.6,50536,6723,43813,19910,30626,2657,16353,10521,2042,3245,
1953-06-01,2.5,50519,6734,43785,19909,30610,2663,16343,10517,2032,3240,
1953-05-01,2.5,50490,6717,43773,19930,30560,2684,16341,10510,2026,3235,
1953-04-01,2.7,50435,6770,43665,19908,30527,2707,16293,10482,2021,3228,
1953-03-01,2.6,50473,6784,43689,19909,30564,2728,16270,10501,2016,3220,
1953-02-01,2.6,50339,6797,43542,19841,30498,2764,16158,10463,2011,3211,
1953-01-01,2.9,50144,6794,43350,19721,30423,2728,16067,10440,2004,3199,
1952-12-01,2.7,50166,6935,43231,19610,30556,2714,15973,10435,1996,3199,
1952-11-01,2.8,49816,6801,43015,19473,30343,2707,15843,10408,1990,3184,
1952-10-01,3.0,49597,6816,42781,19312,30285,2695,15690,10378,1984,3172,
1952-09-01,3.1,49320,6734,42586,19206,30114,2723,15553,10337,1978,3160,
1952-08-01,3.4,48924,6718,42206,18928,29996,2718,15279,10287,1973,3147,
1952-07-01,3.2,48143,6737,41406,18268,29875,2713,14707,10238,1971,3112,
1952-06-01,3.0,48282,6712,41570,18419,29863,2717,14828,10251,1961,3118,
1952-05-01,3.0,48642,6694,41948,18784,29858,2687,15143,10243,1957,3134,
1952-04-01,2.9,48620,6662,41958,18806,29814,2688,15162,10261,1952,3129,
1952-03-01,2.9,48504,6662,41842,18775,29729,2691,15127,10207,1944,3125,
1952-02-01,3.1,48522,6650,41872,18813,29709,2754,15105,10202,1936,3123,
1952-01-01,3.2,48296,6589,41707,18719,29577,2694,15067,10177,1925,3113,
1951-12-01,3.1,48314,6688,41626,18698,29616,2696,15045,10149,1925,3101,
1951-11-01,3.5,48147,6626,41521,18617,29530,2660,14999,10149,1921,3095,
1951-10-01,3.5,48006,6577,41429,18630,29376,2699,14973,10094,1906,3085,
1951-09-01,3.3,47954,6552,41402,18622,29332,2674,14996,10084,1906,3082,
1951-08-01,3.1,48012,6519,41493,18709,29303,2689,15061,10083,1899,3087,
1951-07-01,3.1,48061,6538,41523,18747,29314,2692,15110,10100,1892,3082,
1951-06-01,3.2,48064,6499,41565,18826,29238,2692,15176,10083,1886,3077,
1951-05-01,3.0,47952,6417,41535,18829,29123,2711,15164,10080,1879,3073,
1951-04-01,3.1,47861,6451,41410,18810,29051,2696,15166,10031,1873,3070,
1951-03-01,3.4,47873,6410,41463,18754,29119,2670,15125,10092,1869,3065,
1951-02-01,3.4,47577,6382,41195,18666,28911,2628,15076,9996,1864,3049,
1951-01-01,3.7,47288,6352,40936,18518,28770,2609,14950,9941,1857,3037,
1950-12-01,4.3,46861,6314,40547,18283,28578,2542,14782,9857,1852,3017,
1950-11-01,4.2,46776,6262,40514,18288,28488,2564,14762,9860,1847,3007,
1950-10-01,4.2,46706,6249,40457,18249,28457,2546,14737,9867,1843,3000,
1950-09-01,4.4,46438,6228,40210,18040,28398,2512,14561,9858,1844,2990,
1950-08-01,4.5,46192,6187,40005,17917,28275,2491,14461,9810,1833,2982,
1950-07-01,5.0,45454,6090,39364,17464,27990,2454,14072,9719,1825,2954,
1950-06-01,5.4,45083,6022,39061,17288,27795,2408,13923,9647,1822,2938,
1950-05-01,5.5,44718,6043,38675,17080,27638,2345,13780,9553,1818,2916,
1950-04-01,5.8,44382,6094,38288,16718,27664,2293,13471,9569,1810,2904,
1950-03-01,6.3,43954,6078,37876,16482,27472,2241,13290,9477,1804,2876,
1950-02-01,6.4,43297,5926,37371,16035,27262,2228,13169,9461,1799,2856,
1950-01-01,6.5,43526,5934,37592,16255,27271,2216,13161,9475,1793,2861,
1949-12-01,6.6,43522,5952,37570,16217,27305,2207,13062,9470,1788,2863,
1949-11-01,6.4,43242,5950,37292,16040,27202,2229,12882,9432,1784,2847,
1949-10-01,7.9,42942,5970,36972,15739,27203,2218,12891,9442,1778,2832,
1949-09-01,6.6,43780,5990,37790,16403,27377,2223,13225,9524,1779,2864,
1949-08-01,6.8,43624,5985,37639,16327,27297,2208,13158,9491,1765,2858,
1949-07-01,6.7,43531,5962,37569,16222,27309,2202,13067,9516,1762,2860,
1949-06-01,6.2,43739,5956,37783,16351,27388,2197,13178,9583,1760,2865,
1949-05-01,6.1,43984,5962,38022,16492,27492,2232,13269,9644,1761,2877,
1949-04-01,5.3,44236,5948,38288,16685,27551,2243,13439,9687,1760,2882,
1949-03-01,5.0,44240,5915,38325,16848,27392,2264,13581,9605,1759,2876,
1949-02-01,4.7,44497,5893,38604,17019,27478,2275,13734,9675,1755,2888,
1949-01-01,4.3,44668,5894,38774,17170,27498,2292,13867,9693,1756,2892,
1948-12-01,4.0,45032,5888,39144,17417,27615,2306,14086,9739,1754,2914,
1948-11-01,3.8,45192,5869,39323,17599,27593,2280,14292,9753,1752,2915,
1948-10-01,3.7,45245,5829,39416,17683,27562,2263,14390,9759,1749,2917,
1948-09-01,3.8,45294,5805,39489,17741,27553,2264,14441,9753,1758,2923,
1948-08-01,3.9,45178,5791,39387,17655,27523,2269,14353,9746,1753,2920,
1948-07-01,3.6,45160,5774,39386,17649,27511,2284,14359,9752,1753,2920,
1948-06-01,3.6,45034,5736,39298,17633,27401,2280,14318,9711,1747,2912,
1948-05-01,3.5,44796,5681,39115,17508,27288,2245,14235,9697,1737,2904,
1948-04-01,3.9,44379,5643,38736,17302,27077,2202,14183,9583,1732,2891,
1948-03-01,4.0,44683,5623,39060,17544,27139,2163,14364,9642,1727,2894,
1948-02-01,3.8,44533,5615,38918,17447,27086,2105,14339,9635,1722,2885,
1948-01-01,3.4,44679,5624,39055,17625,27054,2179,14438,9609,1714,2885,
1947-12-01,,44581,5605,38976,17563,27018,2130,14428,9600,1707,2882,
1947-11-01,,44484,5585,38899,17517,26967,2101,14414,9596,1701,2877,
1947-10-01,,44411,5566,38845,17499,26912,2109,14393,9589,1694,2870,
1947-09-01,,44203,5539,38664,17398,26805,2094,14315,9557,1689,2859,
1947-08-01,,43960,5519,38441,17280,26680,2095,14200,9492,1682,2847,
1947-07-01,,43743,5524,38219,17106,26637,2077,14076,9472,1680,2839,
1947-06-01,,43810,5524,38286,17253,26557,2076,14200,9431,1663,2834,
1947-05-01,,43638,5551,38087,17176,26462,2015,14189,9359,1661,2823,
1947-04-01,,43499,5558,37941,17178,26321,1992,14240,9263,1657,2814,
1947-03-01,,43607,5588,38019,17196,26411,1972,14259,9313,1649,2817,
1947-02-01,,43557,5606,37951,17200,26357,1960,14278,9276,1647,2813,
1947-01-01,,43535,5619,37916,17213,26322,1927,14328,9259,1648,2805,
1946-12-01,,43379,5628,37751,17164,26215,1931,14301,9209,1668,2779,
1946-11-01,,43395,5639,37756,17157,26238,1901,14310,9224,1666,2778,
1946-10-01,,43093,5664,37429,17002,26091,1875,14182,9143,1658,2756,
1946-09-01,,42915,5669,37246,16912,26003,1836,14135,9092,1646,2747,
1946-08-01,,42642,5681,36961,16728,25914,1808,13981,9076,1638,2717,
1946-07-01,,42153,5682,36471,16461,25692,1761,13771,8969,1630,2691,
1946-06-01,,41735,5680,36055,16206,25529,1697,13598,8879,1625,2670,
1946-05-01,,41349,5732,35617,15875,25474,1679,13389,8841,1615,2650,
1946-04-01,,40913,5761,35152,15439,25474,1639,13200,8856,1599,2635,
1946-03-01,,40195,5758,34437,15017,25178,1581,12545,8719,1582,2596,
1946-02-01,,39244,5778,33466,14308,24936,1501,11922,8615,1560,2550,
1946-01-01,,39829,5785,34044,15031,24798,1421,12719,8518,1540,2560,
1945-12-01,,39110,5811,33299,14744,24366,1336,12528,8278,1505,2514,
1945-11-01,,38996,5830,33166,14699,24297,1291,12537,8258,1483,2498,
1945-10-01,,38600,5854,32746,14513,24087,1231,12487,8153,1463,2466,
1945-09-01,,38507,5942,32565,14486,24021,1143,12486,8091,1449,2447,
1945-08-01,,40466,6135,34331,16223,24243,1159,14201,8022,1437,2506,
1945-07-01,,40874,6185,34689,16611,24263,1144,14599,8006,1428,2512,
1945-06-01,,41149,6181,34968,16959,24190,1133,14948,7962,1416,2512,
1945-05-01,,41304,6159,35145,17159,24145,1138,15201,7963,1407,2512,
1945-04-01,,41446,6185,35261,17338,24108,1148,15335,7908,1403,2519,
1945-03-01,,41798,6216,35582,17542,24256,1179,15473,7966,1404,2528,
1945-02-01,,41897,6239,35658,17664,24233,1191,15581,7923,1405,2533,
1945-01-01,,41895,6254,35641,17705,24190,1143,15669,7890,1407,2527,
1944-12-01,,41860,6375,35485,17666,24194,1113,15659,7799,1405,2525,
1944-11-01,,41711,6263,35448,17564,24147,1095,15568,7850,1406,2524,
1944-10-01,,41708,6223,35485,17621,24087,1085,15630,7846,1406,2519,
1944-09-01,,41679,6216,35463,17612,24067,1036,15662,7836,1407,2523,
1944-08-01,,41850,6204,35646,17784,24066,1081,15781,7830,1403,2527,
1944-07-01,,41904,6190,35714,17860,24044,1103,15832,7817,1409,2529,
1944-06-01,,41947,6147,35800,17947,24000,1123,15890,7796,1423,2535,
1944-05-01,,41985,6121,35864,18031,23954,1149,15944,7788,1416,2536,
1944-04-01,,42063,6112,35951,18124,23939,1172,16012,7770,1419,2540,
1944-03-01,,42294,6113,36181,18349,23945,1237,16170,7754,1423,2549,
1944-02-01,,42538,6129,36409,18578,23960,1300,16330,7741,1425,2556,
1944-01-01,,42654,6162,36492,18709,23945,1323,16439,7710,1426,2552,
1943-12-01,,42746,6271,36475,18792,23954,1316,16526,7612,1431,2557,
1943-11-01,,42821,6179,36642,18861,23960,1320,16598,7685,1429,2558,
1943-10-01,,42675,6170,36505,18796,23879,1334,16512,7652,1427,2546,
1943-09-01,,42492,6167,36325,18673,23819,1357,16366,7635,1430,2537,
1943-08-01,,42546,6151,36395,18749,23797,1433,16369,7637,1428,2532,
1943-07-01,,42700,6257,36443,18776,23924,1516,16306,7653,1435,2531,
1943-06-01,,42781,6324,36457,18800,23981,1639,16204,7640,1446,2528,
1943-05-01,,42596,6281,36315,18739,23857,1737,16044,7601,1435,2521,
1943-04-01,,42647,6267,36380,18783,23864,1854,15961,7612,1432,2519,
1943-03-01,,42552,6257,36295,18783,23769,1954,15856,7572,1426,2515,
1943-02-01,,42393,6223,36170,18685,23708,2022,15685,7564,1427,2509,
1943-01-01,,42172,6132,36040,18570,23602,2064,15532,7571,1427,2498,
1942-12-01,,41915,6072,35843,18408,23507,2136,15288,7565,1432,2482,
1942-11-01,,41674,6026,35648,18220,23454,2260,14971,7580,1434,2470,
1942-10-01,,41515,5956,35559,18118,23397,2352,14772,7597,1439,2463,
1942-09-01,,41259,5866,35393,18017,23242,2433,14582,7570,1440,2454,
1942-08-01,,40988,5814,35174,17828,23160,2478,14339,7563,1441,2442,
1942-07-01,,40472,5591,34881,17584,22888,2494,14072,7549,1446,2429,
1942-06-01,,40029,5510,34519,17241,22788,2380,13842,7559,1453,2413,
1942-05-01,,39771,5431,34340,17000,22771,2271,13704,7625,1460,2403,
1942-04-01,,39352,5357,33995,16701,22651,2170,13509,7591,1468,2394,
1942-03-01,,38935,5257,33678,16367,22568,2042,13311,7631,1478,2377,
1942-02-01,,38512,5146,33366,16048,22464,1900,13127,7664,1480,2365,
1942-01-01,,38347,5089,33258,15908,22439,1914,12965,7689,1485,2362,
1941-12-01,,38104,4971,33133,15803,22301,1903,12876,7694,1481,2351,
1941-11-01,,38024,4949,33075,15746,22278,1915,12810,7710,1481,2344,
1941-10-01,,37949,4907,33042,15727,22222,1935,12770,7715,1482,2336,
1941-09-01,,37835,4891,32944,15642,22193,1939,12683,7722,1482,2326,
1941-08-01,,37544,4821,32723,15463,22081,1918,12532,7711,1478,2317,
1941-07-01,,37137,4750,32387,15264,21873,1881,12382,7639,1475,2301,
1941-06-01,,36650,4701,31949,14985,21665,1791,12204,7563,1468,2277,
1941-05-01,,36182,4642,31540,14720,21462,1784,11957,7493,1460,2259,
1941-04-01,,35468,4585,30883,14151,21317,1772,11698,7439,1458,2232,
1941-03-01,,35092,4535,30557,14109,20983,1739,11409,7299,1444,2207,
1941-02-01,,34843,4504,30339,13982,20861,1820,11211,7275,1439,2189,
1941-01-01,,34481,4468,30013,13771,20710,1833,10993,7223,1438,2171,
1940-12-01,,34174,4415,29759,13563,20611,1777,10847,7208,1436,2155,
1940-11-01,,33669,4396,29273,13206,20463,1627,10643,7147,1436,2137,
1940-10-01,,33267,4353,28914,12909,20358,1506,10471,7121,1432,2123,
1940-09-01,,32810,4312,28498,12565,20245,1379,10258,7101,1428,2104,
1940-08-01,,32352,4282,28070,12257,20095,1286,10048,7049,1427,2087,
1940-07-01,,31942,4261,27681,11958,19984,1272,9766,7017,1423,2070,
1940-06-01,,31977,4218,27759,12040,19937,1290,9832,7016,1423,2066,
1940-05-01,,31879,4172,27707,12038,19841,1298,9810,6996,1421,2061,
1940-04-01,,31701,4152,27549,12013,19688,1276,9817,6896,1419,2055,
1940-03-01,,31825,4151,27674,12024,19801,1214,9884,6992,1416,2051,
1940-02-01,,31715,4150,27565,12023,19692,1178,9916,6943,1415,2047,
1940-01-01,,31603,4150,27453,11973,19630,1121,9927,6916,1409,2039,
1939-12-01,,31542,4134,27408,12021,19521,1142,9949,6851,1405,2033,
1939-11-01,,31470,4109,27361,12007,19463,1172,9896,6855,1400,2027,
1939-10-01,,31411,4089,27322,11984,19427,1186,9873,6858,1398,2021,
1939-09-01,,31031,4076,26955,11692,19339,1203,9604,6793,1406,2010,
1939-08-01,,30663,4046,26617,11495,19168,1236,9400,6740,1392,1990,
1939-07-01,,30419,4019,26400,11304,19115,1221,9231,6731,1386,1985,
1939-06-01,,30502,4003,26499,11447,19055,1264,9315,6706,1381,1980,
1939-05-01,,30299,4006,26293,11298,19001,1262,9299,6686,1379,1968,
1939-04-01,,30094,4002,26092,11182,18912,1249,9309,6634,1370,1957,
1939-03-01,,30280,4002,26278,11383,18897,1225,9275,6625,1376,1958,
1939-02-01,,30100,4001,26099,11221,18879,1162,9175,6643,1372,1950,
1939-01-01,,29923,3988,25935,11098,18825,1139,9077,6627,1371,1943,
